"id_circ","geom","barrio","perimetro","area","total","masculino","femenino","id_comuna","id_barrio"
16,"0106000020E61000000100000001030000000100000019000000255AB092AC304DC0D511D1D40E4F41C0785450589F304DC0DEEFC45B0E4F41C0B86A59394D304DC04C229683084F41C0B07FBD2549304DC0AD1A5CCE784F41C0190F831F49304DC0FFB2B08A794F41C076EB88DE48304DC03AB769389F4F41C0FAA49A2D44304DC0EF38367ACE4F41C0B95BD15439304DC0A610DDFF035041C0007BA51928304DC063B8DC2B2A5041C0C3F96BC712304DC046BD018A4B5041C02F30A6145E304DC04585AEB7755041C0BAA779885F304DC07F41CA94765041C05796A5CB66304DC031B90D52695041C0E9D7812771304DC0249DABFE545041C0E7F06D1275304DC081F39E60495041C0431F7CAF7D304DC05E58AB24325041C0EAC9AB4283304DC07040F4D3225041C02EEEE42D95304DC052C3B499F14F41C07392CF039D304DC066E6047ED64F41C094858618A4304DC076EB157FA34F41C005E82627A4304DC0C2BF2E61A24F41C074272448A7304DC0EE005886654F41C0B578023AAB304DC0A929A7EB3A4F41C049CA8008AC304DC0E6948018214F41C0255AB092AC304DC0D511D1D40E4F41C0","CONSTITUCION",2894.92736852,298077.37925,8563,4349,4214,1,12
17,"0106000020E6100000010000000103000000010000001600000000D42D4123324DC001FD00481F4F41C0497B7D2E10324DC0CA080DA41E4F41C03E763513CA314DC0DC668C631A4F41C0EF9CD73F98314DC0A8A01C9D174F41C0832D4AFC30314DC09D34834F144F41C07B8409AA06314DC04D4389DE114F41C0A9094B40E7304DC055B41021104F41C0491580C7AC304DC025915CD60E4F41C0255AB092AC304DC0D511D1D40E4F41C049CA8008AC304DC0E6948018214F41C0B578023AAB304DC0A929A7EB3A4F41C074272448A7304DC0EE005886654F41C005E82627A4304DC0C2BF2E61A24F41C08F043345D0304DC02A7F091CA34F41C0118311B401314DC0F87B9FCEA54F41C0D63890B842314DC05DF29F83A84F41C0F8A659058F314DC06F7F7501AD4F41C00D309DD4C5314DC0B91DBC25B04F41C0E3D5C3CCF7314DC0F74F48BBB34F41C010F7F27F1C324DC088F253F7B54F41C0D75A36651E324DC0ED83E0BA8F4F41C000D42D4123324DC001FD00481F4F41C0","CONSTITUCION",3116.47990364,529690.402792,12756,6229,6527,1,12
18,"0106000020E6100000010000000103000000010000001300000005E82627A4304DC0C2BF2E61A24F41C094858618A4304DC076EB157FA34F41C07392CF039D304DC066E6047ED64F41C02EEEE42D95304DC052C3B499F14F41C0EAC9AB4283304DC07040F4D3225041C0CC46E2EBEC304DC0CFDEF82D3F5041C0E2F423692F314DC03A22A8F1415041C0024C8C6F7C314DC09F15C2B6445041C0C5A00CB4D0314DC01455BF07485041C0EEF0F1F011324DC0F8C2B698495041C0CB5690801A324DC0A1F11739DE4F41C010F7F27F1C324DC088F253F7B54F41C0E3D5C3CCF7314DC0F74F48BBB34F41C00D309DD4C5314DC0B91DBC25B04F41C0F8A659058F314DC06F7F7501AD4F41C0D63890B842314DC05DF29F83A84F41C0118311B401314DC0F87B9FCEA54F41C08F043345D0304DC02A7F091CA34F41C005E82627A4304DC0C2BF2E61A24F41C0","CONSTITUCION",3133.84681192,549094.117478,7886,4131,3755,1,12
19,"0106000020E6100000010000000103000000010000001D000000EAC9AB4283304DC07040F4D3225041C0431F7CAF7D304DC05E58AB24325041C0E7F06D1275304DC081F39E60495041C0E9D7812771304DC0249DABFE545041C05796A5CB66304DC031B90D52695041C0BAA779885F304DC07F41CA94765041C0717A49EB5F304DC075269DD0765041C0406647AA85304DC0FEA4124D8D5041C05E80E08976304DC0393D97F8B35041C052A6EE3994304DC0A1032994EA5041C09FBE72EC93304DC0215EA08FEC5041C0929535EF97304DC0957E6A06F15041C07CF7641CA7304DC0FD73BFF6F95041C0E6707498A8304DC0F4BD831A075141C0449F14E4CC304DC0A7186B5E085141C0403ADD50CF304DC0D3CB064CC15041C0B0350AFFF9304DC0AF85989FDD5041C0436E1E3013314DC0C51FFE42EC5041C004281A7C24314DC0B0CA09D0F15041C0811CB57BAD314DC0B98AECB5195141C06D80C240F7314DC0B02F9B1A2B5141C0E5BD56540E324DC07B76182F695041C0A4BC15EA11324DC0C54926EB495041C0EEF0F1F011324DC0F8C2B698495041C0C5A00CB4D0314DC01455BF07485041C0024C8C6F7C314DC09F15C2B6445041C0E2F423692F314DC03A22A8F1415041C0CC46E2EBEC304DC0CFDEF82D3F5041C0EAC9AB4283304DC07040F4D3225041C0","CONSTITUCION",4048.90791204,725811.685945,10799,5784,5015,1,12
1,"0106000020E610000001000000010300000001000000250000004D756C38DF2E4DC025FFDC4A6A4F41C00944A62EDB2E4DC0215B35D18D4F41C046811EEED32E4DC0A7E2C58FD54F41C06C732BA8D32E4DC0DCE965D5D94F41C0F15B8745D22E4DC0C55B2CDADE4F41C0D82B4CFBC72E4DC0BF0ED643DE4F41C0A7E997C69A2E4DC057843A7FF64F41C090E95786872E4DC04C269598FF4F41C032130CA5852E4DC0BD38480E045041C00E7EADE2E82E4DC00709B944065041C0886336EB192F4DC001B77880065041C0FE279126192F4DC0E8B94E36465041C09863FED51D2F4DC0870448DD475041C04CC884E1222F4DC0837158F74B5041C05D72DBCB2E2F4DC008F0C55A565041C05601F1AA492F4DC08C2B29BF6C5041C03548A3B3712F4DC022BD5871935041C03F0C27B47B2F4DC0FB860618365041C02DF78CF7862F4DC08E28487D365041C0C963E9C9AF2F4DC05D21233C395041C0688928B7F12F4DC095AC7B073B5041C0C3F96BC712304DC046BD018A4B5041C0007BA51928304DC063B8DC2B2A5041C0B95BD15439304DC0A610DDFF035041C0FAA49A2D44304DC0EF38367ACE4F41C076EB88DE48304DC03AB769389F4F41C0190F831F49304DC0FFB2B08A794F41C0B07FBD2549304DC0AD1A5CCE784F41C0DBAB251818304DC03073DC52774F41C08BB95090F62F4DC0173834AB754F41C099C81601D72F4DC03B6C97D4744F41C02893E313AE2F4DC05B83C393734F41C0641C264D7A2F4DC0791760E8714F41C02A0F97BD5A2F4DC0D859A54A724F41C0DD78BB6A2A2F4DC08EAFE5CE6F4F41C07BBD6D1FF82E4DC0654F3D1A6C4F41C04D756C38DF2E4DC025FFDC4A6A4F41C0","SAN TELMO",4157.17556283,709721.550229,11377,5695,5682,1,20
2,"0106000020E61000000100000001030000000100000016000000B86A59394D304DC04C229683084F41C058DF07804F304DC03C776475E24E41C05877B02C20304DC08F0C4F6EE04E41C04BEC99D207304DC00BBABA71DD4E41C0C8959DE2EF2F4DC0CD7F669BDB4E41C0373E307EC22F4DC01BE67DFAD94E41C077BA1D96942F4DC0128AE9C2D94E41C06B482035942F4DC00CC8E582D84E41C01175571F6F2F4DC04C844CD2D54E41C050C41687642F4DC0DD3B4F90D44E41C05FB49D1BF12E4DC0A792D5F6CC4E41C04D756C38DF2E4DC025FFDC4A6A4F41C07BBD6D1FF82E4DC0654F3D1A6C4F41C0DD78BB6A2A2F4DC08EAFE5CE6F4F41C02A0F97BD5A2F4DC0D859A54A724F41C0641C264D7A2F4DC0791760E8714F41C02893E313AE2F4DC05B83C393734F41C099C81601D72F4DC03B6C97D4744F41C08BB95090F62F4DC0173834AB754F41C0DBAB251818304DC03073DC52774F41C0B07FBD2549304DC0AD1A5CCE784F41C0B86A59394D304DC04C229683084F41C0","SAN TELMO",3045.85873489,523430.860014,11365,5870,5495,1,20
3,"0106000020E61000000100000001030000000300000085010000C9CD4ECEBB2D4DC03DE9CD6B2C4C41C0221B40A4B92D4DC0869AE17D2D4C41C0DF2ADE06B52D4DC059CB6BA32D4C41C05CC24E55B12D4DC004D767B42E4C41C045A7BE01AE2D4DC0FB1AF1AF304C41C0D21DFAF0AB2D4DC06369CC98304C41C0133820E1A02D4DC0ECD7941E354C41C0C63E45739A2D4DC07EF603E9364C41C03D87DC6D902D4DC0CBB6F79E384C41C097EE2999862D4DC0E4AA9B00394C41C03D4684C7812D4DC0EE32F5C7394C41C08DC739E7762D4DC0C862AD253E4C41C0EFAAC9DC752D4DC04CB8D2E1404C41C0E354D67D732D4DC0C55E2634424C41C0AA5F8DE56F2D4DC0FD098CED484C41C046F1DA16692D4DC027C44E804B4C41C0C7B5F1F1622D4DC0135802A74B4C41C0FD7506F5602D4DC04ADC940E4D4C41C08FC596C5592D4DC0ACA52C2D504C41C02629A2E0532D4DC0A907D111534C41C04661A41D4E2D4DC0B623D9E5554C41C08A218CCD402D4DC0326995605E4C41C07A9C8F653D2D4DC0DDD02D68604C41C0D148BAC2382D4DC074BD487B654C41C0EAB3459F302D4DC0866448CE6B4C41C0D5465ADA282D4DC08404C5557A4C41C0CDA4D414232D4DC0E3BD611D804C41C04263FED81A2D4DC056D5A83F894C41C02CF927C5112D4DC010DF31728C4C41C08BCF83F10C2D4DC04F2391BD904C41C0AAEFD15B072D4DC0C4C227C5974C41C030D68E3F022D4DC07457649C9C4C41C0DD3EF9BEFE2C4DC0EF60E1E39F4C41C0E248F937F82C4DC08AA92F56A44C41C0DEB3D78AF22C4DC0E32DB441A94C41C04143AFBAEB2C4DC039A246A0AD4C41C0DBA10B9CE82C4DC096999307AF4C41C0F84A848EE22C4DC0554D9C36B14C41C0356029E8DF2C4DC01BC4B4DEB34C41C0751F89E1DC2C4DC08A837195B54C41C0A9D2BD4BD72C4DC07BEA16C5BC4C41C08371029BD32C4DC091464694BF4C41C0CBCE9012CD2C4DC0615E1018C84C41C05BE17CA0C82C4DC0E52A6987CB4C41C0CAABE2FCC32C4DC034FFBC5ED04C41C0FF50051FBE2C4DC0025C4045D44C41C0FFF50550B72C4DC025D52E50D74C41C08508A093A42C4DC072F8892DE84C41C0B913C72F9F2C4DC03D636170EA4C41C09CC1A9679B2C4DC0DA0D65FBEA4C41C03A68AA79982C4DC002C8DD4AEB4C41C0E1BEC741952C4DC0BAC4E1A1ED4C41C02A2FB3B08D2C4DC0A70CE524F14C41C05CB1CEE48B2C4DC0D0031078F24C41C09ACA0357822C4DC066E0A0CAF84C41C0ABEB227A7C2C4DC08E79FBB8F94C41C0F9BBE8267B2C4DC06DFD6F21FB4C41C0D31439BF772C4DC00C536310FC4C41C004F97D5A722C4DC0B64A6BBF004D41C01F1D4F0B6F2C4DC01282FAC6024D41C033EDE1946C2C4DC08B48734A064D41C0E354BD286B2C4DC0678BEFCE094D41C06E246C656A2C4DC09EF2BADE0D4D41C0D6E7D61F682C4DC04BC475BE0F4D41C082CEF18D672C4DC0777978B6124D41C0EAF1D65F652C4DC05DED8076164D41C0A8EDE224642C4DC00363647A174D41C02481916D642C4DC0417B7FE2184D41C0386624A0622C4DC0300474521C4D41C0C4900124622C4DC000EDBFEE254D41C0842F31285F2C4DC01C3CDAFC284D41C038515E035F2C4DC0E9DCC1B22A4D41C0401728CF602C4DC00D1A75DF2B4D41C04904465E612C4DC07F1106B8304D41C0694675305F2C4DC060CCADCB354D41C0F5AA58B65E2C4DC05F2F2B98374D41C0E3C4B0D05C2C4DC06E5DE45F3D4D41C05259CF395E2C4DC04E46C160424D41C0947AAA235C2C4DC0BBAE1399464D41C02710B92F5B2C4DC05D0DF9A04D4D41C027C23B775B2C4DC0FA2D5735504D41C0EC39C7FF582C4DC0901B9B89564D41C0DE925947592C4DC0023CE1F5584D41C00A10136F562C4DC02A00A7E95F4D41C0595B497B552C4DC0BC10AD71644D41C0DBEBBF0E542C4DC0CF33FD0D694D41C0B7ACE583512C4DC0E8BCAB776A4D41C0C80B796B4F2C4DC04EF658A56C4D41C03B48941B4C2C4DC05BC76F8C704D41C09AE31BAB4C2C4DC048AF7A39744D41C00D604D5E4E2C4DC011AEC6B9764D41C0F10FD4FA4D2C4DC0D7D560BE7C4D41C0F580E6344F2C4DC0D4681D3B7E4D41C0AE7B8DB94E2C4DC046C94E93854D41C0589969954D2C4DC010515D438A4D41C05202534A4D2C4DC0990802B0914D41C03C2A3C6F4C2C4DC02345F1A7944D41C033BDEDC34B2C4DC0E63210119B4D41C01C8CF259482C4DC0D3AB7140A24D41C010DD0E9A452C4DC0D9C53780A84D41C0D533F926412C4DC06EC4BA5BAE4D41C026B559453D2C4DC02A0E307FB24D41C0F1F7B28D2F2C4DC0225F72C0B94D41C0BF82576E2C2C4DC0AA7CE6DFBC4D41C04B8A0778262C4DC0D4F34117C14D41C05E40BF8C212C4DC01CDD2B5AC34D41C0064FA7DF1B2C4DC061EE8369C74D41C04B8AE21A082C4DC009E77215D14D41C09914D93BFB2B4DC004300503DC4D41C0FFF8E21FF62B4DC0ADA30A4ADF4D41C0E07741A6EE2B4DC0BE339920E44D41C0F0395C29E92B4DC0FF454B57E84D41C0AE80E2DBDC2B4DC0A85CBD45F34D41C053057C87D42B4DC0727959FCF94D41C05774BE5CCD2B4DC0D16673A1FF4D41C026F68148C72B4DC0A72ED7F5024E41C0F90EED57BD2B4DC0A0AD50400C4E41C0604B651DB52B4DC09E328F3A104E41C07CF2D30DAF2B4DC06974762D174E41C0F8A7CA40AD2B4DC058106A511B4E41C02A8B4A52A12B4DC0939C783B2A4E41C07C138367A12B4DC0BDDF0C0C324E41C071DF83BCA02B4DC0574A3254354E41C0C1BDF9ED9E2B4DC07BDC37753D4E41C0DA9953E29D2B4DC095DB05F9404E41C0F0673930982B4DC0ADB11D15524E41C0F5B27EA1932B4DC0D3DB58D15E4E41C0C23989F9902B4DC027883439654E41C0E28F6CE18E2B4DC00CA08A51704E41C0949AA9AF8C2B4DC0904636727D4E41C038ABF6CD862B4DC0B1C34E9A8C4E41C01F1F2556842B4DC058736152934E41C07363F8FD822B4DC00EBECA9EA14E41C0A1EC0613832B4DC01C14F5D3A94E41C05626B981802B4DC074501310B44E41C0D83A1E06802B4DC0B7EFCBB0B94E41C0F324FD05802B4DC0F8901D0FCE4E41C0CF3EC961802B4DC06C178CC0DC4E41C00492A0D0842B4DC0253762C6E24E41C00CF81959892B4DC094CB48D8E64E41C07EB7A62F962B4DC0ABF1F0B7F14E41C055BA67B49C2B4DC03581DE9BF64E41C0EFEBFB02A02B4DC016E5F6BAF64E41C03ADF573BA82B4DC0556D3001F94E41C0C31F49ADAC2B4DC0B63401DBF84E41C028F1CED4B72B4DC05898D329F84E41C0125E62F8CB2B4DC00720A702F74E41C037A4A2C6D22B4DC0C8510C18F74E41C0E5F930B7DA2B4DC033C064BAF74E41C0540D0371DF2B4DC094CC2E0FF94E41C0B304B29FE62B4DC0EC9B4189F94E41C04B908933EC2B4DC094341B07FB4E41C005615B04F12B4DC0E4A28474FD4E41C09E95A10EFE2B4DC0D83D054C014F41C0EF1E9D2B082C4DC0A5B1D22E034F41C07D9D86ED0F2C4DC0FDA00D8A054F41C0AE9875AE112C4DC02E69E29B054F41C061B1B106152C4DC013222027064F41C072B7557E162C4DC0252DB97D064F41C0F18F9344172C4DC0E7BBA510074F41C06000AEE0192C4DC09CDF7A50084F41C047FA49581B2C4DC07E2B87C1084F41C0224F2DA61E2C4DC060D845B9084F41C0001A866C1F2C4DC0A7314BFE084F41C07B574980292C4DC04A094B3D094F41C01C25CD842C2C4DC024C50EB7094F41C005DA4974332C4DC0185F73B0094F41C0A9C7D4543B2C4DC06EC488A0064F41C0FEE82E8E3E2C4DC09092F408074F41C0147C44CC402C4DC0F1CF1D71074F41C0B1421E59422C4DC0C1FA4B94074F41C01467FE33432C4DC013E7B471074F41C005E9CB43442C4DC02EFC7BFD064F41C0EB6CB60A452C4DC041FDE0B0054F41C06D0F7DF0472C4DC09A568F8F054F41C0E8283392492C4DC0FD891859044F41C098FFEB584C2C4DC0528F358D044F41C0C593857C4F2C4DC04D090D97044F41C00D2ADDCF512C4DC09BD140A8044F41C0F619E7E9522C4DC076A33919054F41C054CE7FE9542C4DC00897B619054F41C0F2E6691D552C4DC0E8BA6081054F41C0BC868912552C4DC0B80F546A064F41C085975202562C4DC0F25900F2084F41C0DF0329D3562C4DC0B37B8973094F41C01408D07E582C4DC0BAC209F6094F41C0DBBED7205A2C4DC0EB05C2FE094F41C0932F9D835B2C4DC00AA2C89F094F41C0876A48015C2C4DC0D9B6717A084F41C0DA638B175A2C4DC0899B8D6B064F41C0F191876B5A2C4DC07CC696D0054F41C05FFD6B4B5C2C4DC030C10BD1054F41C0984C338A5C2C4DC074256760054F41C09FC651EE5B2C4DC043D79F7F044F41C0C1891F765C2C4DC038F62491044F41C037F8A73B5D2C4DC0A0205A0A054F41C0B8B6C2995D2C4DC0D98B7DA5054F41C03691B66A5E2C4DC074387DC8054F41C049658E995F2C4DC02FB4ED0A054F41C0A25E945A612C4DC0703C8EE8044F41C0BF441C7A612C4DC02CD14959054F41C0C3273207612C4DC0343D4DFD054F41C01DC415CD5F2C4DC02FCF1098064F41C04A5B4B065F2C4DC07ED8D280074F41C0CE5056745E2C4DC0595DB972084F41C01339659D5E2C4DC005AAA1A9094F41C0C2AD246E5F2C4DC0952AFA6F0A4F41C02D4A048C602C4DC059712ABE0A4F41C0AF5376B1642C4DC08A567B43094F41C0089EB07B652C4DC03ABEDD3C094F41C09551E97C682C4DC019605D52084F41C0880A84EA6B2C4DC044022B31084F41C05D69E11E6C2C4DC0B8FBE358074F41C08BDB334E6B2C4DC0C7B5BD6F064F41C01B20DA626D2C4DC085F370A4064F41C0BF9C5EE56E2C4DC00177641A064F41C03EDE8F53702C4DC0DD71EB7E054F41C0B7C6FDE4722C4DC097D001E6044F41C06FD3A70B742C4DC0A24AC2D6034F41C089DA5729782C4DC09066FBE7024F41C02B8D89A67A2C4DC01364C1EF014F41C0FACD9FEA7B2C4DC091D67BDA004F41C09CC1E2487E2C4DC0871DB3E0FF4E41C0073F214F7E2C4DC0F57B374DFF4E41C03C3FFD617F2C4DC0AF7D3EBCFE4E41C0B7E6FB07822C4DC066EE08A5FD4E41C0BB9CCFF6842C4DC0B1ADA161FB4E41C05DB8138F882C4DC07B951F0EFA4E41C0A70B93348B2C4DC0B1B4F25EFA4E41C065FFEFFC8E2C4DC0FFF46B97F94E41C0C52BFB63922C4DC0518C90D0F84E41C0276EC2D9942C4DC065EEC77CF74E41C011031E11982C4DC0ABE8B819F74E41C0DAB558AC9C2C4DC0CFF87685F74E41C0D970DBBC9D2C4DC0C137BE2EF74E41C025C0A57AA02C4DC000CA5107F74E41C0E6DE9A80A32C4DC04CAA62A8F74E41C0C54A7B30A72C4DC09B6D04E5F74E41C05227D32DA92C4DC03DD7CCB5F54E41C06CD01731AE2C4DC040BB8A3AF44E41C0443F75C5B02C4DC0719A76FFF54E41C096BEAD93B32C4DC00C5AA690F84E41C011050835BF2C4DC07D1FEA23FB4E41C0990D6570C42C4DC04EE7233BFD4E41C02536A092C62C4DC07A38EA78FD4E41C0E7FAED09C82C4DC0BE8FE3CFFE4E41C0ABD0C9EECA2C4DC07F0C1429FF4E41C0BD85E517CC2C4DC0A49E0EB9FF4E41C05A3B9852CE2C4DC02AF2AC2A014F41C017A9DDD8D32C4DC070A2DB87004F41C034975A7ED52C4DC0C331A269014F41C063908995D52C4DC0F4F0DB61064F41C083889583D62C4DC011525E91074F41C006009719D82C4DC0BBB51697094F41C028DE4F86DD2C4DC0ABA2450A0D4F41C0432D55D8DF2C4DC06E6A98E3104F41C03DFB4E10DF2C4DC05D697B75154F41C09ED96B83E02C4DC03E6F6B441A4F41C067E5D3BCE22C4DC07C53C0501D4F41C0B87B3054E72C4DC0CB096642204F41C08395E35CD82C4DC0CAFCD6111F4F41C003E09892D12C4DC0C53468BF224F41C0BB5D2547CE2C4DC0C7811944224F41C0BB7A2235CA2C4DC02AA4E5EF1F4F41C0FBE68F09C62C4DC033C770B2214F41C06ABC1943C82C4DC03E5D9081264F41C0398271E8C92C4DC09689A1DE274F41C0CABC4C3BCC2C4DC018F50A51294F41C040ECF51BD02C4DC0227B325C2A4F41C00047B396D02C4DC046AF443F2D4F41C04F2411E0CB2C4DC00D0E94A62F4F41C057037DBCCB2C4DC015D5DF21324F41C005291AF1D42C4DC0BEFCDC24344F41C0E33446DBD72C4DC0E499C00E304F41C06DA2BC2EDA2C4DC01B289EBD2F4F41C0405F3C29DE2C4DC0AC17C7E52B4F41C084A53B76E42C4DC03B993BB42C4F41C01681554BE32C4DC066DD0E302F4F41C0BDD2F8A3DE2C4DC0D93AED06314F41C06FFCD990DD2C4DC05CAB0E5E324F41C0AC5CEFCBD92C4DC0D18A3035364F41C0654482E8D82C4DC02BB5D546394F41C09AAFD63BDB2C4DC0434F71853B4F41C0228B9866DF2C4DC0282107263C4F41C047412898E22C4DC09C73CD883F4F41C0C2BE40FBE22C4DC02CDDBDFA404F41C0FEFEB9D3E72C4DC0A20CBB24414F41C0BD521AAFF12C4DC0E988356B454F41C0E9AF6883F42C4DC042135BA5454F41C04F99A2F7F42C4DC062E7F3A3454F41C08AB5A2AAF82C4DC05891F597454F41C0231BBFDFFC2C4DC0ACF3A2A4444F41C0C8361702FE2C4DC0B4CFCFF8424F41C09B9CFB9BFE2C4DC0145DB2E0404F41C0322E18C6002D4DC0EAB61959424F41C0024987AA012D4DC0FBFF5EF4424F41C0CEFC43A2FF2C4DC0DCB5D32D464F41C0E8F830BFFC2C4DC0F531512E474F41C0F5843BDA022D4DC0598A10B64A4F41C0AF9B5926072D4DC035D093284D4F41C01115EE9E0B2D4DC0923899B54F4F41C09C256957152D4DC0F2DF0124504F41C066632344202D4DC00E2430324D4F41C05C7959DA202D4DC0891879094D4F41C0761B8C06252D4DC0F2FA8EA7544F41C0EFD70BEB262D4DC06594287F544F41C01FDC4A492C2D4DC03D637A13544F41C02D30E1D12C2D4DC00B0F7401544F41C03789C4E12C2D4DC0C80832E0534F41C0E75688E22C2D4DC0E13532E0534F41C0AAF1ABEE2F2D4DC003031FAE4F4F41C09B841CE3312D4DC072B046FE4C4F41C0BC79940D402D4DC0677EAFA9484F41C0B75DF7074D2D4DC0B4EC41944F4F41C05E19F346522D4DC0C9E8745F524F41C020827B0A582D4DC059EF87984A4F41C09819B238752D4DC01525AF6D4D4F41C079E70F35772D4DC0EBC9B281494F41C0AEC694D7802D4DC0E8E99782354F41C0386CA0258B2D4DC0AEB32A641E4F41C0EEEA8D54912D4DC02ED1BAC90E4F41C072334737992D4DC09DB59C38174F41C07AC7624E9C2D4DC09CC721DD1A4F41C02E3EFB95A02D4DC0F5F360531D4F41C07CF3A544A42D4DC01437A943214F41C064656CE0B52D4DC0FA3FDC02344F41C0F6E1EB14D82D4DC0FE7BA56D584F41C063414ACBD82D4DC006F7712F594F41C0B96CA228FD2D4DC0A579C7307F4F41C0AE1F902A152E4DC07EA4C6FF974F41C019359ACD162E4DC0D2BC7AAB994F41C022B7F2F3222E4DC0C867BE13A64F41C02F1E5A942C2E4DC02CCC1938B04F41C0A97FB105412E4DC0E98E11AEC54F41C0BCD3E72B4A2E4DC0EE324ED2CF4F41C0288DB0484E2E4DC0A8096E5BD44F41C02699026A522E4DC0434EEAF2D84F41C02D81AB67552E4DC06B70B045DC4F41C0B15861AA5D2E4DC03F7AFA3EE54F41C0176920316A2E4DC0DD5F59DAF24F41C0B31ABA71792E4DC0221BA6A8035041C032130CA5852E4DC0BD38480E045041C090E95786872E4DC04C269598FF4F41C0A7E997C69A2E4DC057843A7FF64F41C0D82B4CFBC72E4DC0BF0ED643DE4F41C0F15B8745D22E4DC0C55B2CDADE4F41C06C732BA8D32E4DC0DCE965D5D94F41C046811EEED32E4DC0A7E2C58FD54F41C00944A62EDB2E4DC0215B35D18D4F41C04D756C38DF2E4DC025FFDC4A6A4F41C05FB49D1BF12E4DC0A792D5F6CC4E41C077D736E2FD2E4DC03978EF7E5A4E41C0376852A5F92E4DC0DDC895255A4E41C0F42642D2EC2E4DC01937F7B15A4E41C0157B2176C62E4DC0D5E1787A584E41C0CB793A2F962E4DC00D5B2AB4554E41C0771E8F958D2E4DC0449561B2554E41C07D1827A0892E4DC002EBC2954E4E41C0172EE307812E4DC0561A46644C4E41C0E19ADA4B0D2E4DC06A3FFFA3444E41C054059064012E4DC0A65D7F15444E41C0B76D8FCAF82D4DC06AD47A2B454E41C0F0A82C91EB2D4DC0651BF76C424E41C02F8AE28EED2D4DC0E00C77693C4E41C066B72D40EC2D4DC013361305324E41C0198F54EFEA2D4DC04382DA002C4E41C00826198AF72D4DC00B05ABF00D4E41C03762FE9B322E4DC0440592ED634D41C0041574FC702E4DC034DA0B5BB34C41C0D5F02CF87F2E4DC045A3D4A68A4C41C04E381E0E822E4DC0BA2F3ECA834C41C0C6E91CDE862E4DC08CFC549C744C41C0BC4B1438882E4DC030B9C79E704C41C016D74A07852E4DC018B9E7F06F4C41C0AFEED8A3852E4DC078D609AB6E4C41C0B731D95D802E4DC0A4D8CB8C6D4C41C0E4E34D79742E4DC095D53928684C41C052138FE2592E4DC0D9C345E15B4C41C066B84B7D3C2E4DC03B414A7D4E4C41C0D01EB98A352E4DC042DCC0514B4C41C01B300047262E4DC0E5EFC65A444C41C08B80FF79182E4DC06A287B073E4C41C0ED381AF4FB2D4DC0A8C6C1F6304C41C01EEB2C48E42D4DC0CF30E3FC2E4C41C0D9DB02CDCC2D4DC09C185ADB2D4C41C0BE0DF1A9C82D4DC0C53484A82D4C41C06691CEB9BC2D4DC0C2308CFA2B4C41C07B4CC1B0BC2D4DC0BB6AC8F92B4C41C0C9CD4ECEBB2D4DC03DE9CD6B2C4C41C07D000000CC0F7D0BC62E4DC0EBB964F6654E41C01D1C3E37C62E4DC0ED6D2FF7654E41C05AD38B6AC62E4DC04C9401FB654E41C09C37C491C62E4DC02F40EB0A664E41C0F98BB8B6C62E4DC0B53C8915664E41C0D2FA75E2C62E4DC076497022664E41C0C38DFE14C72E4DC0B5D92939664E41C0E4F8F73FC72E4DC0B3D13155664E41C0E42D6563C72E4DC09631087B664E41C0AB248D87C72E4DC025CE65A2664E41C0C8E6AB9FC72E4DC0D4C832C5664E41C07C92B9AEC72E4DC07069C4E8664E41C09AB3F1B3C72E4DC00065560F674E41C06C5931B9C72E4DC0FEEEDE2F674E41C04D82E4B9C72E4DC04388005E674E41C0319CC7B0C72E4DC0962BEA8F674E41C0D194A9A7C72E4DC0C9AA9CC5674E41C005013D99C72E4DC0351CB20C684E41C099C70CC4BD2E4DC03693CE1CBE4E41C0EF563CA0BB2E4DC079DA64CACF4E41C0CC548BDDB42E4DC0DBB9B2440B4F41C0398E27BFB42E4DC09D012AF70B4F41C0893508BFB42E4DC0CD958B5F0C4F41C033219DADB42E4DC0568B308F0C4F41C06D017A9EB42E4DC07CB540B70C4F41C02F3F6973B42E4DC0CD38DFE60C4F41C06B6C9744B42E4DC06B9D600A0D4F41C0D0A24717B42E4DC0F6A39A280D4F41C095AAECE0B32E4DC09069F93C0D4F41C0013AECB8B32E4DC04AA487470D4F41C05AE30778B32E4DC0B867814A0D4F41C04170761AB32E4DC02655A5460D4F41C048B275C4B22E4DC0A7C5803D0D4F41C02EE3C4D29E2E4DC02A0330BC0B4F41C0FD578A839E2E4DC03FD2A0BA0B4F41C0CE46A91A9E2E4DC091D7ABAD0B4F41C0DA91FDD29D2E4DC05BCE51A80B4F41C050F740859D2E4DC0218010AF0B4F41C0D005A0469D2E4DC099FE99B90B4F41C0E3A9ED019D2E4DC00FAD38CD0B4F41C039ADC0BE9C2E4DC08D5C05DA0B4F41C059B2907E9C2E4DC087FD95060C4F41C0AD93F4459C2E4DC0109EC01E0C4F41C07E63890C9C2E4DC03BFE6E570C4F41C08BAB79E19B2E4DC08B3742830C4F41C058D17CC29B2E4DC031D89DB00C4F41C0DED77CA99B2E4DC0B539B2F70C4F41C0AEECB3A19A2E4DC0889A0CF2154F41C036785DB5932E4DC0F9FC0E73154F41C09CB796A5942E4DC00B0504160D4F41C069E239B0942E4DC027E151E00C4F41C0861A56B6942E4DC0DE4FCBA00C4F41C0E12495AC942E4DC011A1CF680C4F41C04302949D942E4DC053B98E2E0C4F41C03A88478C942E4DC0D4CAD6F80B4F41C062E25A61942E4DC036C0F3B00B4F41C05FD7E131942E4DC08157EA750B4F41C0C989A704942E4DC0C4EB0B4D0B4F41C0DB4C65D4932E4DC0220B3B2D0B4F41C040B8E1A1932E4DC084DFF7110B4F41C0DA9B4563932E4DC06D19B8F90A4F41C0A0D95919932E4DC0B41A47EB0A4F41C0AD4D22CA922E4DC0B075DEDF0A4F41C0217AC48D922E4DC0117D48DB0A4F41C0AEF6B3B67D2E4DC0E02C865D094F41C07B016C5E7D2E4DC074E2AA59094F41C0CC46451B7D2E4DC01FF59656094F41C0955630E17C2E4DC0FC7CE142094F41C056055DA97C2E4DC028E66B2E094F41C0443FA27D7C2E4DC0A405ED16094F41C0975DA8527C2E4DC02A94E9FA084F41C02C7C73257C2E4DC07B57A2C0084F41C050B6560A7C2E4DC02AF5FF93084F41C0296486F47B2E4DC038BD815D084F41C0F4AA62F87B2E4DC0842E5D10084F41C06CFE86017C2E4DC0412DC3C7074F41C00E54B10A7C2E4DC001D67F6B074F41C0BF5B5558822E4DC0F60DD4C0CF4E41C0F3C14AA68E2E4DC0C2DCB175634E41C0C89D6FB28E2E4DC00B018F28634E41C063A423BD8E2E4DC046ECE7BA624E41C0D73C47C68E2E4DC0D040D073624E41C04827F5DC8E2E4DC072EA7246624E41C072A95FEE8E2E4DC023885118624E41C0553A50078F2E4DC071E1CCF4614E41C094D6A2348F2E4DC0C5BD3ACB614E41C038DAC8718F2E4DC074BC0EB0614E41C0304FA8AC8F2E4DC08C9EE497614E41C020C8181D902E4DC06A33208B614E41C087054188902E4DC052C27B8D614E41C0B69D0C13912E4DC01C2380A0614E41C09DAA9178A52E4DC0B5A8874B634E41C06E686CDEA52E4DC0BBE0F456634E41C03A496831A62E4DC0A81D575F634E41C06CEF1DA4A62E4DC08ABA1754634E41C0AC57DBF1A62E4DC053D4A333634E41C08DFD133BA72E4DC08C09F919634E41C01F8B6368A72E4DC0D60A3FFA624E41C02FD4C39EA72E4DC0C3A671D1624E41C01545CBC3A72E4DC05FB2869C624E41C08DAECFE5A72E4DC027CE5565624E41C0845B40FAA72E4DC075107233624E41C00418F410A82E4DC01B2B6AF2614E41C052815F1FA82E4DC01134DEAF614E41C091C2230EA92E4DC07E2D5016594E41C0CE4872E7AF2E4DC09D9EFCAE594E41C059863401AF2E4DC0BE7E0593614E41C0E706D1F5AE2E4DC06C307FCC614E41C00F39AEE9AE2E4DC08C149513624E41C082D75FEAAE2E4DC03E39BA41624E41C00CBE94E9AE2E4DC07CFA4A68624E41C0A98EC1EBAE2E4DC09474D4A7624E41C00C1E49F6AE2E4DC0FA89E7CC624E41C0BA549107AF2E4DC02B3A54FD624E41C0456A2621AF2E4DC083F76B41634E41C02996CF46AF2E4DC02C6F1D74634E41C0883E406DAF2E4DC0E33F439F634E41C098FB0CA8AF2E4DC0823523C5634E41C0F2AC24E8AF2E4DC0A14EB4E5634E41C061A86918B02E4DC0675829FA634E41C00B198758B02E4DC03FDE5F0C644E41C0F4250DB3B02E4DC0F2D01B20644E41C0844B1A12B12E4DC02105042A644E41C06061D0F6BD2E4DC05677A034654E41C0CC0F7D0BC62E4DC0EBB964F6654E41C060000000BC634F0FA02E4DC0453727B7CA4F41C0E499E100A02E4DC021ADC3FFCA4F41C041307CF89F2E4DC0B7F8A14ACB4F41C0BECEE8F39F2E4DC030238A7CCB4F41C037A8D2ED9F2E4DC01D531DA3CB4F41C00B873AE99F2E4DC099648BD6CB4F41C052C55EDC9F2E4DC0F2F744F3CB4F41C0A86475C69F2E4DC0BC15BC0DCC4F41C0C74B1C969F2E4DC0FC208736CC4F41C0CC57C55F9F2E4DC0CB93433ACC4F41C01BFA85389F2E4DC0C18D423DCC4F41C05B9EBC099F2E4DC06055C241CC4F41C09057B0D89E2E4DC07B32B841CC4F41C08D55EE296D2E4DC05F4B83ACC84F41C0B85196F06C2E4DC0B197A2A2C84F41C0B9E728AB6C2E4DC05A58CC9EC84F41C04BE801686C2E4DC05A42B198C84F41C0F5C6D4216C2E4DC00287229AC84F41C050A5FCE96B2E4DC0255727A0C84F41C01AFAA1B36B2E4DC04268FCAFC84F41C0B107847C6B2E4DC00CD961C7C84F41C02674C2566B2E4DC0D2CA13E1C84F41C03C0208376B2E4DC0FB5EBCF7C84F41C0ABEE1E7C562E4DC0B17CDC8CD64F41C060592410552E4DC03FCCD961D74F41C075E2FCE4502E4DC0957CA2EBD24F41C0EC7D39B9532E4DC0476E9019D14F41C00617058D662E4DC00A342DBDC44F41C0315A9BBF662E4DC090BF329EC44F41C08310EDEC662E4DC0AF98F67CC44F41C073522F11672E4DC0CFAB7C5FC44F41C0EE62282D672E4DC063C1DE2FC44F41C00CA32749672E4DC0BEC1B9FEC34F41C08F5EE062672E4DC0FD3F3DC2C34F41C00592B869672E4DC094B51994C34F41C00F8C83F0712E4DC01A4BCF71634F41C01E5AB400792E4DC04D27ADA4224F41C09A788E04792E4DC0BE4CB46C224F41C0E8878214792E4DC03B9C3011224F41C02B5B5818792E4DC0A47A3CD9214F41C0F5CA852A792E4DC0C89E46A1214F41C093314247792E4DC0CFB92E76214F41C0B675FF66792E4DC087028E46214F41C06CFB8F93792E4DC0438B5728214F41C01FD41EC3792E4DC08504E70D214F41C03EC5F9FA792E4DC066E5CCFB204F41C00A9CE83E7A2E4DC015A744F1204F41C006C66A937A2E4DC0345249EB204F41C0FD174AF97A2E4DC0875F2DF2204F41C007D7A47C8F2E4DC06E01AE76224F41C0854431D78F2E4DC0AE7B887A224F41C0D3D25142902E4DC01F9DBE89224F41C0793C078D902E4DC03039BB80224F41C017C78DDE902E4DC02E955769224F41C06592FE20912E4DC0BEE76A4D224F41C09815DF5B912E4DC09D554435224F41C0D878549E912E4DC01B39340A224F41C0C3E614C4912E4DC0654409F2214F41C0E71326EF912E4DC07CA11FBD214F41C08843861F922E4DC0FD90997A214F41C082A2D243922E4DC08CB89539214F41C0E1A6FB4C922E4DC0D10B1AE1204F41C01CD91050932E4DC00A09208A184F41C039F7AE419A2E4DC01D53AF10194F41C03EEE6D5B992E4DC0E5F013E4204F41C069EDD859992E4DC0B769C419214F41C07C58E649992E4DC0A3E80976214F41C0D2C45951992E4DC00D5DA7BE214F41C0B3F5A362992E4DC0303165F7214F41C034978881992E4DC052EE1F2D224F41C002B65191992E4DC005EBBF59224F41C0A10B6CA9992E4DC0E5AC9E82224F41C01B0B47C2992E4DC0532FB1A7224F41C0F5524AF9992E4DC00BD276E0224F41C00F0B6E429A2E4DC0730AA50B234F41C05E517A799A2E4DC08C93722B234F41C048C2F3A29A2E4DC086D2DC39234F41C0556DD5E39A2E4DC0F15B554E234F41C067D230209B2E4DC033F9B256234F41C07DBF54639B2E4DC074709B63234F41C083D6E3989B2E4DC08D48756A234F41C0522A10DF9B2E4DC0C4EEC76C234F41C0C7584A4AB02E4DC05A30A9E9244F41C0EB17DBA7B02E4DC0F02E8BF0244F41C0EDF617FDB02E4DC0367DCF08254F41C0DEF27A42B12E4DC0C6122127254F41C01613BE72B12E4DC05D8BAC44254F41C0218B2B99B12E4DC0EECDC169254F41C0509689B0B12E4DC0A6C17B83254F41C08EE2A2C8B12E4DC02A2722B0254F41C0DDEC6DD8B12E4DC0B5D9B9D6254F41C06D4165DBB12E4DC07FE7DB04264F41C05AAC56DEB12E4DC010A8A946264F41C03509B2D3B12E4DC0E408A781264F41C04199DB77AB2E4DC08BEF636F634F41C0BC634F0FA02E4DC0453727B7CA4F41C0","PUERTO MADERO",14439.5856232,4248032.90197,702,416,286,1,41
4,"0106000020E6100000010000000103000000030000002500000077D736E2FD2E4DC03978EF7E5A4E41C04E2E0A4C0E2F4DC0B818D46BC74D41C0F1FA135C0F2F4DC01B72692DBE4D41C08562311F112F4DC09FBFA4E6AE4D41C02DFD36DF112F4DC09EF13F5FA84D41C031FAFCB6172F4DC0846C0DA8754D41C004F2CB10272F4DC055F6D39EEE4C41C06831C1F84B2F4DC0D0462E26964C41C01401C25F1E2F4DC0F7A591C5994C41C02591804F1B2F4DC0075FCBA4984C41C0BB7668D4132F4DC052DBEFFA944C41C0F4DA88E1052F4DC087F11E90934C41C0833705E5032F4DC0925F15BA934C41C0B2CE8EA8EA2E4DC0AFC1FFCA954C41C0284BD89AD72E4DC098527037954C41C0FDEBCBE1922E4DC0DFE353D08F4C41C0F33251C48E2E4DC0A2549A798E4C41C08A564F1D7F2E4DC0204435788D4C41C0D5F02CF87F2E4DC045A3D4A68A4C41C0041574FC702E4DC034DA0B5BB34C41C03762FE9B322E4DC0440592ED634D41C00826198AF72D4DC00B05ABF00D4E41C0198F54EFEA2D4DC04382DA002C4E41C066B72D40EC2D4DC013361305324E41C02F8AE28EED2D4DC0E00C77693C4E41C0F0A82C91EB2D4DC0651BF76C424E41C0B76D8FCAF82D4DC06AD47A2B454E41C054059064012E4DC0A65D7F15444E41C0E19ADA4B0D2E4DC06A3FFFA3444E41C0172EE307812E4DC0561A46644C4E41C07D1827A0892E4DC002EBC2954E4E41C0771E8F958D2E4DC0449561B2554E41C0CB793A2F962E4DC00D5B2AB4554E41C0157B2176C62E4DC0D5E1787A584E41C0F42642D2EC2E4DC01937F7B15A4E41C0376852A5F92E4DC0DDC895255A4E41C077D736E2FD2E4DC03978EF7E5A4E41C089000000FC23D40BDA2E4DC097FF6F47A34C41C089A827BCDE2E4DC0906B0B02A34C41C094689EF6E22E4DC0A174824BA34C41C0A3B3EE6EE12E4DC0DC9CCD96B04C41C0B71D99B6E12E4DC02E9072A1B04C41C053FE00B5E12E4DC00B713FE3B04C41C0509DA3ACE12E4DC03C00AE16B14C41C071A99BB2E12E4DC043BBA74EB14C41C02118A2C1E12E4DC0869CE888B14C41C0433140DEE12E4DC0F7B21BBDB14C41C0355D9AFBE12E4DC05B924CEEB14C41C0F6AC0622E22E4DC0B581BD1EB24C41C00084545BE22E4DC0A1E7083DB24C41C0169F98BCE22E4DC0EE4AE25CB24C41C02229C808E32E4DC0019A1E72B24C41C01330274EE32E4DC0D71F0D82B24C41C06CF5EE04F62E4DC04035B1F7B34C41C04DC5BF3CF62E4DC068E145FCB34C41C07486A986F62E4DC0FF18E403B44C41C00A7BB4B7F62E4DC0DF0BE800B44C41C0AEAD56F9F62E4DC07AB07E05B44C41C0CA57333AF72E4DC0802C2210B44C41C069BAD178F72E4DC038FB7915B44C41C0F3E952D3F72E4DC0BC84C22DB44C41C029C3AD18F82E4DC08D130F4CB44C41C05F75B74FF82E4DC0627CD065B44C41C07912F97FF82E4DC0BD13947FB44C41C0F9F9FDB6F82E4DC0C7BE84AEB44C41C0E0CDEAE1F82E4DC0048610EBB44C41C01D7889FEF82E4DC03706C01DB54C41C062395914F92E4DC06E903A54B54C41C03E6FE92AF92E4DC03D9E378CB54C41C02F7B6832F92E4DC01349A2BCB54C41C089BEDB33F92E4DC07B8340E9B54C41C039010545EE2E4DC0F2C4EFAB144D41C071B1875FE42E4DC0BDF039D66B4D41C0E6C39E52E42E4DC0A3F69A226C4D41C0B312424DE42E4DC0FD3E68646C4D41C034A2DD3EE42E4DC0E565C7916C4D41C0C4090738E42E4DC0702BA2BD6C4D41C031F0DE25E42E4DC036A7FAE76C4D41C02077F10CE42E4DC07E18F0036D4D41C061393AEDE32E4DC0951D34256D4D41C02FE948D4E32E4DC09F02A63F6D4D41C08FC2FFA6E32E4DC006A75C5C6D4D41C09B20B679E32E4DC08B2A356C6D4D41C0F0551C41E32E4DC03B65FE756D4D41C0239C1010E32E4DC0D3D5837D6D4D41C097E453BCE22E4DC074C32E7B6D4D41C0F6558A5FE22E4DC04318FC6B6D4D41C01A5FB24CCE2E4DC076DC04D46B4D41C0BD3337FBCD2E4DC0052FEDD06B4D41C006FDCDB5CD2E4DC0120DDFD06B4D41C080823F58CD2E4DC030A349CF6B4D41C03573880ACD2E4DC0C86414DC6B4D41C0EFD2E5C8CC2E4DC08A6296E36B4D41C01D364F93CC2E4DC0A1B0E3EE6B4D41C0605ECD6CCC2E4DC00A0FCE046C4D41C0A0FBAA32CC2E4DC0892646256C4D41C0642984F8CB2E4DC040226B596C4D41C053C528C5CB2E4DC0B3F580876C4D41C0E2B9BAADCB2E4DC0E16DDFB46C4D41C05CB4318ACB2E4DC0CE0316EF6C4D41C0FC35047BCB2E4DC0C553383C6D4D41C05349206ECB2E4DC0804C35776D4D41C08F71CB6BCB2E4DC045552DAF6D4D41C0D9EB881CCB2E4DC0E1BFABD26D4D41C062CD4257CA2E4DC09CE8431B744D41C0DF0FDF2EC32E4DC00DC45086734D41C065E13EF4C32E4DC0428B44EB6C4D41C00BD8B1C1C32E4DC0228A72E76C4D41C0DBA30FC7C32E4DC0A85C9FA26C4D41C02C712DCDC32E4DC01F6DD3606C4D41C0A2DFBCCBC32E4DC01F67821D6C4D41C021427FC0C32E4DC08BBBCBE76B4D41C0B6C375AEC32E4DC0571646AB6B4D41C01F216399C32E4DC0B3B85F7C6B4D41C0EBA00982C32E4DC05B1187566B4D41C06F6EE160C32E4DC09097AD306B4D41C00A3D7B3DC32E4DC07EA853096B4D41C061968918C32E4DC032D9A9F86A4D41C0168676DBC22E4DC03F4198D96A4D41C0B2B337AEC22E4DC012E323C56A4D41C02A2A845DC22E4DC0263CD1A66A4D41C069A519EAC12E4DC0D4BF99976A4D41C0C18EC185C12E4DC037B201966A4D41C0A85DC22FC12E4DC0E235EA926A4D41C0D3B392E3C02E4DC0263044886A4D41C0AED17049BE2E4DC05AEDB0656A4D41C0BC8BDDC9AC2E4DC0F0B6002C694D41C0A3D42779AC2E4DC02C6E2828694D41C013EC0536AC2E4DC06B2CF718694D41C0392EB6FCAB2E4DC0F2E4FD02694D41C062B781D5AB2E4DC0B67A3FE9684D41C0DDE81EB8AB2E4DC04BDDAAC5684D41C01A203F99AB2E4DC091E7BE96684D41C05B8FBC8EAB2E4DC0AFCF2B70684D41C051F3438DAB2E4DC03A7D1348684D41C003430E88AB2E4DC0A0216515684D41C0DFB2E08BAB2E4DC0EDA045E7674D41C0F9942988AB2E4DC09764A3BA674D41C06302BC26B52E4DC070D3D5A1144D41C0DEFF8867BE2E4DC0B6DFE3BDC14C41C0E099E23CC02E4DC0A7059534B24C41C074B58E4AC02E4DC047C101EFB14C41C00AD4F152C02E4DC0145D23A4B14C41C07F1D0A59C02E4DC05B387D74B14C41C02249A663C02E4DC00C8C4E40B14C41C02EB34F77C02E4DC0CF153112B14C41C07122058EC02E4DC03DFAFEDAB04C41C08A6E35A6C02E4DC040136DB1B04C41C0CCB566BEC02E4DC0FBFD5989B04C41C0E509E9E4C02E4DC0E6D54961B04C41C0B410300FC12E4DC08E88DB46B04C41C09C623B3AC12E4DC04B701021B04C41C0E462516EC12E4DC078982005B04C41C01D19A3A1C12E4DC05DD188F4AF4C41C0DE77C4DEC12E4DC04EA326E0AF4C41C0E19FC206C22E4DC03B5C98D5AF4C41C0DD56CA37C22E4DC08949A8D8AF4C41C002933780C22E4DC0C37EF6D7AF4C41C0E0312ACDC22E4DC0A47144D7AF4C41C0CCB54C10C32E4DC09B9CDBDBAF4C41C0B617BA3CD62E4DC02CDFA170B14C41C037DA137CD62E4DC00F303875B14C41C01FB2B3BAD62E4DC01D73BB70B14C41C0815BD4F7D62E4DC0EADDA05EB14C41C02F2FE92BD72E4DC0F3CF7946B14C41C069850A69D72E4DC04C8C1732B14C41C02CB7DC9AD72E4DC07A2C1A10B14C41C0705E64C1D72E4DC0DB4842E4B04C41C099C261E0D72E4DC0BAA31DB3B04C41C0D135A2FED72E4DC08B08D36FB04C41C0E7119C17D82E4DC006ADBF28B04C41C053927E24D82E4DC0C95B8AF1AF4C41C040719586D82E4DC063CF14EDAF4C41C0FC23D40BDA2E4DC097FF6F47A34C41C088000000841A74AFBE2E4DC02A155782804D41C081E98CE9BE2E4DC0BDF76282804D41C0EB31E625BF2E4DC0DEABFE89804D41C007A39E76BF2E4DC0F8087298804D41C0261A08BFBF2E4DC06B6FC19A804D41C02A430F18C02E4DC045A5C694804D41C038368260C02E4DC09A8FB585804D41C0583BDA96C02E4DC062A35C74804D41C0BCB03DD3C02E4DC0220CF259804D41C04C76D805C12E4DC02948EA34804D41C07BC1E333C12E4DC0D6C3E20F804D41C00E35ED58C12E4DC037BB84DF7F4D41C0068C1790C12E4DC00C26EE937F4D41C0928A07A6C12E4DC01C08005F7F4D41C0FFD925AFC12E4DC060FAC9277F4D41C02B7D5CBEC12E4DC0695764BC7E4D41C012BC66EFC12E4DC0A83A2ABA7E4D41C0CB1F67D3C22E4DC09DC8AFA2764D41C0D2E2841ECA2E4DC0E224972E774D41C03FF96A28C92E4DC0CF81C7437F4D41C00245355DC92E4DC00609AE507F4D41C0F4EB5456C92E4DC0A4429DA17F4D41C09F857D4FC92E4DC02BE1C0CF7F4D41C0CE4D7355C92E4DC0BF6A460F804D41C024EBF05CC92E4DC0096BDC35804D41C08608B566C92E4DC06F6E6959804D41C0CEF13E71C92E4DC0EE602B76804D41C03B24CA81C92E4DC00074819D804D41C0232DA69DC92E4DC0FE0EA5C8804D41C0068A3CB1C92E4DC0544DF2E9804D41C095C7A4CEC92E4DC0268EA700814D41C093A42404CA2E4DC0CF79D72E814D41C0029B1D2FCA2E4DC04B2C5749814D41C009FD5C5CCA2E4DC084F9475C814D41C08898598ACA2E4DC0EF02CD76814D41C037A899B7CA2E4DC0017F7887814D41C04B9527EDCA2E4DC085454C8B814D41C07640B64ACB2E4DC031B3E18C814D41C0333045ABCB2E4DC012F5CF99814D41C0323B7BFACB2E4DC025DDAEA0814D41C03FEC1184DF2E4DC0D67CB02B834D41C030DE32C7DF2E4DC0C3341C3A834D41C008A38C03E02E4DC0966B3540834D41C0E45B5832E02E4DC08CAB7339834D41C0C807AD6EE02E4DC0406B1D47834D41C01EB901A8E02E4DC07CD6344D834D41C09C2F03D6E02E4DC0670C5E5C834D41C032A9FC00E12E4DC003525B75834D41C085B8B529E12E4DC09497548B834D41C0A64DD744E12E4DC08E33D2A5834D41C02103365FE12E4DC0579148BD834D41C089191A81E12E4DC017905FFE834D41C0D3322796E12E4DC0EFE1452D844D41C0FBF3A69DE12E4DC0813B6B5B844D41C0FD37B18AE12E4DC09C6167B5844D41C07F6AD086E12E4DC035DC5406854D41C001949382DD2E4DC0EFA20B5DA84D41C0CD70B297CC2E4DC0480A910C3C4E41C0C7266FBDCA2E4DC0713671AB4C4E41C0675B4FB4CA2E4DC0C4B430E74C4E41C04491BDB2CA2E4DC017870C134D4E41C017D5A1A9CA2E4DC0DE7D2E414D4E41C07B85C59CCA2E4DC06985B4614D4E41C09F006491CA2E4DC017B31D954D4E41C00706656FCA2E4DC02776E9BA4D4E41C0F37C3054CA2E4DC0187972DE4D4E41C0F140AC2DCA2E4DC0597201084E4E41C0901B59FDC92E4DC07BD733234E4E41C00872FCC6C92E4DC0D5C6A6404E4E41C04C64A390C92E4DC0A0B9FF514E4E41C01EA33048C92E4DC0FD9FC55B4E4E41C05954A012C92E4DC055797C5C4E4E41C00BEEE1BEC82E4DC0809652504E4E41C094705A64C82E4DC0881F40504E4E41C09E7B160CC82E4DC0242114444E4E41C03B6C6DFCBD2E4DC08B6284704D4E41C0BFF37EBFB32E4DC0C6F471A14C4E41C098B58F4DB32E4DC053C04E9B4C4E41C0B396AE0CB32E4DC0C59178974C4E41C02E8D4FD0B22E4DC09842739A4C4E41C06C039E8BB22E4DC05DDC90AF4C4E41C0B85E0A56B22E4DC0D84B29C04C4E41C00EC8AE1FB22E4DC01504D8D94C4E41C07A661AF0B12E4DC058144BF74C4E41C0CDFF10C5B12E4DC02B94F8104D4E41C070C2D2A0B12E4DC0172409394D4E41C0BCD57B79B12E4DC02D38DB804D4E41C0DDDCCA62B12E4DC0B09945B44D4E41C00318306DB02E4DC0F0EB8783564E41C0F3C8C359A92E4DC09F822CF9554E41C0AE083A49AA2E4DC065C3B78A4D4E41C0F6FDDA50AA2E4DC0CC96113C4D4E41C032DBE74DAA2E4DC0EFA04F004D4E41C078C0E441AA2E4DC04390E7CF4C4E41C07C682135AA2E4DC02CAA379D4C4E41C05FF94016AA2E4DC0E6B64B6E4C4E41C02E7258F4A92E4DC080A132494C4E41C0360356C0A92E4DC073C74B1D4C4E41C09E85C787A92E4DC02C6F7AFD4B4E41C02C376945A92E4DC0CC84B0E04B4E41C0E2086314A92E4DC0434C48D24B4E41C0354C45D4A82E4DC0651B94C14B4E41C01B12D085A82E4DC0B5E82CB64B4E41C08DFFA1AD932E4DC060C1EC174A4E41C00F9ED578932E4DC00FE8CE0E4A4E41C07B5A7C14932E4DC069A5300A4A4E41C04FBB1AD2922E4DC03C1E47FD494E41C0C010F08B922E4DC07CA832FA494E41C0FA11BC67922E4DC0C59150ED494E41C0E8A1443E922E4DC0A5701DDB494E41C052647A09922E4DC049E1D3BC494E41C08CAB17EC912E4DC09B0858A5494E41C00222E9C7912E4DC02AB2C681494E41C04FEE8AAD912E4DC000AB325E494E41C0FF46EF90912E4DC0F323C72D494E41C002A23487912E4DC054A2BFEF484E41C0CB927E86912E4DC059CED2BD484E41C011899D8F912E4DC08734DC85484E41C0B8315D01932E4DC0A695C6063C4E41C03339642CA42E4DC079BA136EA84D41C04F1216BAA82E4DC095403332804D41C0AAB46ABFA82E4DC08131650C804D41C0727A8DC8A82E4DC08A7CCDC67F4D41C0320E6DD5A82E4DC039FCF39A7F4D41C0B8858EE4A82E4DC0D4F1A7767F4D41C05E8504FFA82E4DC0DEEB984E7F4D41C0AED84423A92E4DC0850B5D307F4D41C0502DC346A92E4DC091DE761A7F4D41C042427A69A92E4DC0A61E5E0B7F4D41C04893CF9FA92E4DC08C2D18037F4D41C0C14AA5D7A92E4DC081D1CDFA7E4D41C0AD19A905AA2E4DC01C9C1CFD7E4D41C07A03E054AA2E4DC05399F4007F4D41C0A788FDBFAA2E4DC0436A660C7F4D41C0F0798840BE2E4DC00D83AB96804D41C0841A74AFBE2E4DC02A155782804D41C0","PUERTO MADERO",8028.11547007,777372.455097,489,307,182,1,41
12,"0106000020E6100000010000000103000000010000000F00000044E32ABC23324DC0448E0A58914E41C0338FD44525324DC0DE29331E6C4E41C0BAF721832B324DC07728DD1EFD4D41C0A0ED413AD0314DC07EC7086FF64D41C01B4A14629E314DC0F437DDFCF04D41C0134026D48F314DC02C2D49DFEE4D41C02FF7902915314DC0B797FEC9E54D41C08AD2709FE4304DC0B46BF7BDE14D41C0137B1A17BB304DC0ACB6CB59DF4D41C0945EDF01B8304DC0D574C66B184E41C054AD0609B4304DC0AFEB863A774E41C07B6588BEFB304DC07904EFC27D4E41C01207E01F6C314DC0C992EB3D844E41C0D2691ECCDD314DC0059728DB8C4E41C044E32ABC23324DC0448E0A58914E41C0","MONSERRAT",3086.33110052,528858.262162,14284,7670,6614,1,42
13,"0106000020E61000000100000001030000000100000012000000255AB092AC304DC0D511D1D40E4F41C0491580C7AC304DC025915CD60E4F41C0A9094B40E7304DC055B41021104F41C07B8409AA06314DC04D4389DE114F41C0832D4AFC30314DC09D34834F144F41C0EF9CD73F98314DC0A8A01C9D174F41C03E763513CA314DC0DC668C631A4F41C0497B7D2E10324DC0CA080DA41E4F41C000D42D4123324DC001FD00481F4F41C01114273121324DC0699272F5CE4E41C044E32ABC23324DC0448E0A58914E41C0D2691ECCDD314DC0059728DB8C4E41C01207E01F6C314DC0C992EB3D844E41C07B6588BEFB304DC07904EFC27D4E41C054AD0609B4304DC0AFEB863A774E41C0B87B4B69B2304DC017B2BF0C9E4E41C0BCCA2075AE304DC079BF151CCF4E41C0255AB092AC304DC0D511D1D40E4F41C0","MONSERRAT",3077.82099139,511682.799259,13733,6741,6992,1,42
14,"0106000020E6100000010000000103000000010000002600000054AD0609B4304DC0AFEB863A774E41C0945EDF01B8304DC0D574C66B184E41C0137B1A17BB304DC0ACB6CB59DF4D41C0C0384F11BA304DC0BA8A404BDF4D41C0149152135C304DC09599CE8AD94D41C0D30B40CEFE2F4DC0B397C0EFD34D41C049F2F75BCF2F4DC03D8ED7D5D04D41C07CF25A51CF2F4DC0554629C7D34D41C02F3DD4507A2F4DC0D2937AC4CD4D41C0083E78827A2F4DC0D90EB6F9C84D41C0FB098159752F4DC04A7D402EC34D41C0C4DC7652712F4DC074CCF353BF4D41C00BC23E2E662F4DC05EC25379B84D41C09559F628662F4DC0161A4876B84D41C037A42988622F4DC0B1389653AB4D41C02517A02F622F4DC074505745A44D41C098011FFC562F4DC009B77578A34D41C0FA02B5E74B2F4DC0888DB222A24D41C0324E86EA492F4DC000753CDEA14D41C05A231D80492F4DC079CCDCF7A14D41C09A5D6D7A472F4DC05FA48373A24D41C0AD7EB277432F4DC0180B1AB6A44D41C0C6A2C9E5442F4DC0E1D59054A94D41C04EF27C8F402F4DC0B467CFFFAA4D41C0502ADFED342F4DC02AA05DAAAC4D41C02F9681572A2F4DC0052A27C3AD4D41C0152F4960242F4DC095859261AE4D41C0F8C901E71E2F4DC09DFC6827AF4D41C08DE9B1FD1A2F4DC087A229A1AF4D41C08562311F112F4DC09FBFA4E6AE4D41C0F1FA135C0F2F4DC01B72692DBE4D41C04E2E0A4C0E2F4DC0B818D46BC74D41C077D736E2FD2E4DC03978EF7E5A4E41C01974BC2F6F2F4DC0C4022BD9634E41C06CDF60DBA22F4DC045F7E905664E41C0E4F6F75144304DC0B07BF3C06F4E41C06A703613A9304DC0A8D27D3A764E41C054AD0609B4304DC0AFEB863A774E41C0","MONSERRAT",3657.82174246,647703.147461,5989,3572,2417,1,42
15,"0106000020E61000000100000001030000000100000016000000B86A59394D304DC04C229683084F41C0785450589F304DC0DEEFC45B0E4F41C0255AB092AC304DC0D511D1D40E4F41C0BCCA2075AE304DC079BF151CCF4E41C0B87B4B69B2304DC017B2BF0C9E4E41C054AD0609B4304DC0AFEB863A774E41C06A703613A9304DC0A8D27D3A764E41C0E4F6F75144304DC0B07BF3C06F4E41C06CDF60DBA22F4DC045F7E905664E41C01974BC2F6F2F4DC0C4022BD9634E41C077D736E2FD2E4DC03978EF7E5A4E41C05FB49D1BF12E4DC0A792D5F6CC4E41C050C41687642F4DC0DD3B4F90D44E41C01175571F6F2F4DC04C844CD2D54E41C06B482035942F4DC00CC8E582D84E41C077BA1D96942F4DC0128AE9C2D94E41C0373E307EC22F4DC01BE67DFAD94E41C0C8959DE2EF2F4DC0CD7F669BDB4E41C04BEC99D207304DC00BBABA71DD4E41C05877B02C20304DC08F0C4F6EE04E41C058DF07804F304DC03C776475E24E41C0B86A59394D304DC04C229683084F41C0","MONSERRAT",3517.08542222,512380.420856,10212,5416,4796,1,42
9,"0106000020E6100000010000000103000000010000002C000000F1ADC811CD304DC03859BC32AD4C41C0BC6C224CCC304DC0DCF08229AD4C41C08F16406F9B304DC0EBAC5CEEAA4C41C0A7E82BC66B304DC0399C78CBA84C41C0EA00F5810D304DC012EF9962A24C41C06D9A9CD2B72F4DC05DA79D239C4C41C0F77F29868D2F4DC0ACB022FF984C41C017D5CF6F842F4DC092177352984C41C06831C1F84B2F4DC0D0462E26964C41C004F2CB10272F4DC055F6D39EEE4C41C031FAFCB6172F4DC0846C0DA8754D41C02DFD36DF112F4DC09EF13F5FA84D41C08562311F112F4DC09FBFA4E6AE4D41C08DE9B1FD1A2F4DC087A229A1AF4D41C0F8C901E71E2F4DC09DFC6827AF4D41C0152F4960242F4DC095859261AE4D41C02F9681572A2F4DC0052A27C3AD4D41C0502ADFED342F4DC02AA05DAAAC4D41C04EF27C8F402F4DC0B467CFFFAA4D41C0C6A2C9E5442F4DC0E1D59054A94D41C0AD7EB277432F4DC0180B1AB6A44D41C09A5D6D7A472F4DC05FA48373A24D41C05A231D80492F4DC079CCDCF7A14D41C0324E86EA492F4DC000753CDEA14D41C0FA02B5E74B2F4DC0888DB222A24D41C098011FFC562F4DC009B77578A34D41C02517A02F622F4DC074505745A44D41C037A42988622F4DC0B1389653AB4D41C09559F628662F4DC0161A4876B84D41C00BC23E2E662F4DC05EC25379B84D41C0C4DC7652712F4DC074CCF353BF4D41C0FB098159752F4DC04A7D402EC34D41C0083E78827A2F4DC0D90EB6F9C84D41C02F3DD4507A2F4DC0D2937AC4CD4D41C07CF25A51CF2F4DC0554629C7D34D41C049F2F75BCF2F4DC03D8ED7D5D04D41C0D30B40CEFE2F4DC0B397C0EFD34D41C0149152135C304DC09599CE8AD94D41C0C0384F11BA304DC0BA8A404BDF4D41C0137B1A17BB304DC0ACB6CB59DF4D41C0B7DA84F5BF304DC03758453C854D41C04EF228C8C3304DC00E1396A0454D41C04588D246CA304DC01AE71C85D94C41C0F1ADC811CD304DC03859BC32AD4C41C0","SAN NICOLAS",4418.86873719,1184441.82519,12534,7564,4970,1,43
10,"0106000020E6100000010000000103000000010000001A0000004860A6AD84314DC0381ACA93B54C41C0F1ADC811CD304DC03859BC32AD4C41C04588D246CA304DC01AE71C85D94C41C04EF228C8C3304DC00E1396A0454D41C0C727462ACA304DC0A3EFADA1454D41C078B9878BCC304DC03EFDA6F7494D41C0BD480A5BD0304DC021974DF8494D41C0B038D038DD304DC0CB57185F4A4D41C075EDB882E1304DC00E74E095494D41C023693FD9E4304DC03AA1B49E474D41C08BCB3FB5E7304DC011523ED5464D41C0BB999A4B04314DC0F50A8CD2484D41C049F6C48C1D314DC0624FE3694A4D41C05A48207833314DC0A97C73374B4D41C0139F6E8379314DC0EC1962984F4D41C04685D61996314DC056266995514D41C0131A2849D9314DC034BDFE23574D41C0E4ADA88C06324DC0692885B65A4D41C065E92D0D2F324DC036963E7E5D4D41C071FD34C136324DC0505A16F05D4D41C04EC4C5C536324DC0966C17B55D4D41C0B95BE3EC39324DC06A46F366344D41C0D1BEAC7E4B324DC0A6A442E6C04C41C0812FBB314B324DC035EDADE1C04C41C07238DE85E2314DC0E7131BF0BA4C41C04860A6AD84314DC0381ACA93B54C41C0","SAN NICOLAS",3178.48277049,552953.581882,14356,7632,6724,1,43
11,"0106000020E6100000010000000103000000010000001C0000004EF228C8C3304DC00E1396A0454D41C0B7DA84F5BF304DC03758453C854D41C0137B1A17BB304DC0ACB6CB59DF4D41C08AD2709FE4304DC0B46BF7BDE14D41C02FF7902915314DC0B797FEC9E54D41C0134026D48F314DC02C2D49DFEE4D41C01B4A14629E314DC0F437DDFCF04D41C0A0ED413AD0314DC07EC7086FF64D41C0BAF721832B324DC07728DD1EFD4D41C0E63865C92B324DC01F185823F94D41C00D6B91B833324DC0E00345BD854D41C071FD34C136324DC0505A16F05D4D41C065E92D0D2F324DC036963E7E5D4D41C0E4ADA88C06324DC0692885B65A4D41C0131A2849D9314DC034BDFE23574D41C04685D61996314DC056266995514D41C0139F6E8379314DC0EC1962984F4D41C05A48207833314DC0A97C73374B4D41C049F6C48C1D314DC0624FE3694A4D41C0BB999A4B04314DC0F50A8CD2484D41C08BCB3FB5E7304DC011523ED5464D41C023693FD9E4304DC03AA1B49E474D41C075EDB882E1304DC00E74E095494D41C0B038D038DD304DC0CB57185F4A4D41C0BD480A5BD0304DC021974DF8494D41C078B9878BCC304DC03EFDA6F7494D41C0C727462ACA304DC0A3EFADA1454D41C04EF228C8C3304DC00E1396A0454D41C0","SAN NICOLAS",3151.36370357,551579.237608,15584,8286,7298,1,43
5,"0106000020E6100000010000000103000000010000008A070000C43DC79D18314DC00C5F5E9B034A41C0722AF1470F314DC08D8A44AB054A41C048801FE30D314DC0B9E673FA054A41C0C7CABB4700314DC081A53FE10A4A41C00C49A503F4304DC04E7F2029124A41C0621677D59F304DC0E75C82BD414A41C0B2C85E589E304DC0E3B09095424A41C05F7236AC25304DC051140FD83B4A41C04AB7052904304DC0BD9828FA4E4A41C0D53A0D72DE2F4DC0EC164811204A41C0E642B488DE2F4DC035B57104204A41C0AE610D55DA2F4DC0F51DF6ED1A4A41C095BF4385E82F4DC08B6C38FA124A41C0E450012AE82F4DC02EDDA9FB124A41C0B2EB5AE2E72F4DC0CD11C9F1124A41C00B29A15DE72F4DC05C95E7ED124A41C07D2E30B6E62F4DC0E35FEAE0124A41C0CFA288EC1A2F4DC0D1977CCB024A41C0E62B4BDC192F4DC0CA47E1B9024A41C05B7C1C5F192F4DC0942026A9024A41C0F3FFCDFA182F4DC013A68EA7024A41C006AAFF9A182F4DC06E1112B2024A41C0BCA10148182F4DC0FDDBBDCE024A41C0BAD29702182F4DC0A642FFF2024A41C0E02C08A8172F4DC09E014D20034A41C0EF900830172F4DC036F41268034A41C04BE55E9E162F4DC05CF0B1BF034A41C02A339060C62E4DC0715EF4A6314A41C0F7210F3FC32E4DC021522F72334A41C0B4E296A6C22E4DC08DE580C4334A41C0B868B040C22E4DC0F156D310344A41C08F1F5AEBC12E4DC072A04C6F344A41C0F80E53CFC12E4DC0BAE5E6D6344A41C0A223B844C02E4DC0526115F7414A41C00C8DB14AC02E4DC0EACD8C2D424A41C062013B5EC02E4DC08EAEC161424A41C0CABDEE89C02E4DC004D1B393424A41C0072EEDC0C02E4DC05CCC91B9424A41C08E5281FFC02E4DC07753D7D4424A41C04FD4F956C12E4DC01A58D4E7424A41C0693F21CEC12E4DC03A2683F2424A41C033E17838C22E4DC0B51AE4F7424A41C044440E9B6E2F4DC0E2B30A87504A41C0652890266F2F4DC09E58FA90504A41C0CB4ACC7E6F2F4DC0A765A59B504A41C0BBDAB1C86F2F4DC0282FAEB7504A41C06F8566F46F2F4DC029AF34D5504A41C0FB0E971B702F4DC0E76641F4504A41C0E6D6BD3F702F4DC0CB95B124514A41C04EC44553702F4DC03F9C8266514A41C0A03EBB5D702F4DC0547B39BB514A41C0FE969554702F4DC0EECC5121524A41C087C885B86F2F4DC0E9616A38574A41C0E30B4B726E2F4DC0A8CDFCA3584A41C06A43B8D1532F4DC0877053D8674A41C00B6088493C2F4DC03B912B48754A41C0AB6711AE3B2F4DC04BBAFD98754A41C00DCFEF483B2F4DC05ABC27D3754A41C06C9777FD3A2F4DC049C7A2F6754A41C0D9B6D1BB3A2F4DC0EF8F040B764A41C0163CD3653A2F4DC07A1D8A15764A41C0E1D0B5C9392F4DC0146B5E0F764A41C00725B714392F4DC034E99A01764A41C01C6C3E0E382F4DC0B522FCEC754A41C06F6BBF2C372F4DC034CD65D8754A41C036E0EC11BF2E4DC0212BD13C6C4A41C00F2591F16B2E4DC0E45A94A8654A41C0980C22A06B2E4DC0305B709F654A41C06E7D5A436B2E4DC02E34959B654A41C07F966CF66A2E4DC009BE4C9F654A41C037E495BB6A2E4DC0344E53A8654A41C0E4E91F706A2E4DC0DF9C48C7654A41C08E2C0E146A2E4DC0B0585AF5654A41C09BE25CCF692E4DC0DA07211E664A41C07ED39F53262E4DC070C2656F8C4A41C0FBECD1FF252E4DC0B6E8CFA88C4A41C0B1E014B2252E4DC0EA7128D98C4A41C0B2426B76252E4DC00EFED5118D4A41C0FC885748252E4DC09939C84C8D4A41C0EE37182A252E4DC0B64D47898D4A41C0E5F5291A252E4DC0AE97A7D58D4A41C01B17B10B252E4DC0177AD1448E4A41C02A0482BA232E4DC057DCBC709A4A41C036B0B2BF232E4DC0D61447B09A4A41C020F273CF232E4DC0329E37019B4A41C0335D07EC232E4DC0FAC2BF3D9B4A41C023F9F216242E4DC0F4D706789B4A41C06CA7E647242E4DC0BFFD10B39B4A41C0A384F587242E4DC0F5767EE09B4A41C0746398D5242E4DC0D5E4B8119C4A41C06AAB5132252E4DC0A77555329C4A41C0E8F7639A252E4DC04896843E9C4A41C0D3121C1C262E4DC0AB63BA4A9C4A41C04225EFFCBE2E4DC0CE0DB95FA84A41C0EFEED51CDC2E4DC02EFF13AFAA4A41C0F4DF1E7EDC2E4DC0EA9E3AB8AA4A41C07C6ADDDADC2E4DC0BEEA3ACEAA4A41C076E20D30DD2E4DC035C6DAF1AA4A41C0A0C40C67DD2E4DC07290D826AB4A41C0E7CA15A7DD2E4DC0FB18F86AAB4A41C0DE16D8B9DD2E4DC0468265BAAB4A41C0A13FBABCDD2E4DC0849FA32FAC4A41C05B004CD0DD2E4DC0BCE2306EB14A41C0C94A2ACADD2E4DC008CD1CBFB14A41C0BB5A0BC4DD2E4DC037437F0BB24A41C09AD819AEDD2E4DC0D3EC034BB24A41C0D1885766DD2E4DC00952A49CB24A41C09D8B56CCDC2E4DC0A6045219B34A41C000685173DB2E4DC0337EA731B44A41C0B3D8ADF5BE2E4DC0082F63B8CA4A41C0E5CD7E26B82E4DC0ACD41C00D04A41C07B714FE3B72E4DC0C3407830D04A41C00754E77BB72E4DC094FB047CD04A41C02E6AFD3DB72E4DC0031ED2A4D04A41C0A01799FBB62E4DC012C980C1D04A41C0EC14E0ADB62E4DC017959CD6D04A41C06769EE60B62E4DC05271A4DFD04A41C091471A29B62E4DC0E99559E0D04A41C00A6A74DEB52E4DC048E92DD4D04A41C0F9C6DDA2B52E4DC02776D6CED04A41C081183658B52E4DC0CA25BAC8D04A41C03F5F0DAA252E4DC004B428C5C54A41C029D1C9D3122E4DC092B6EE2AC44A41C022FAC174122E4DC00E3BDA2AC44A41C0A54D4420122E4DC05D90D830C44A41C0AAF124E3112E4DC074E4B846C44A41C0A11BCDAC112E4DC0F7E8E561C44A41C09684A06C112E4DC099B8CA96C44A41C07632A04A112E4DC0C15AEEC7C44A41C04A72662F112E4DC03F966401C54A41C09E94AD18112E4DC009E2EF43C54A41C07F3F120E112E4DC0139BC86FC54A41C08F397009112E4DC0574E38C2C54A41C081E3D0F20A2E4DC03CEF54B6FD4A41C0B9AEB7EF0A2E4DC0BF9728FBFD4A41C0582C11E80A2E4DC0E9A18A47FE4A41C01D1203EE0A2E4DC004903293FE4A41C0659210090B2E4DC0F8B069E6FE4A41C0FBE9C2370B2E4DC07F6C8027FF4A41C07548F1670B2E4DC0F6D60C64FF4A41C0FD238FB20B2E4DC0E6B0169CFF4A41C054A2B6040C2E4DC0E8138ECCFF4A41C076021D500C2E4DC006A3DAE7FF4A41C0FD4622AF0C2E4DC095D6C3F1FF4A41C0CB62EA3C0D2E4DC0B0D07EFFFF4A41C0889F3FFD0D2E4DC01FCA4B10004B41C0F25F21240F2E4DC038797C26004B41C07C55C9EA8A2E4DC0755F69C3094B41C0D14C134C8B2E4DC0E8BACECB094B41C026FEC59C8B2E4DC0BABA44DD094B41C0B6A719D98B2E4DC02E673CF0094B41C0FC6047FD8B2E4DC0EABD76080A4B41C09DEB9F178C2E4DC0157EC5290A4B41C0FA31FB318C2E4DC04262E5540A4B41C0BF9D0C478C2E4DC0DECF0E830A4B41C0C099BE4D8C2E4DC09A70EACA0A4B41C0AB4318438C2E4DC0439A20210B4B41C0E6E902E1872E4DC0168437CF314B41C03E9396D2872E4DC07285D017324B41C099FD73C6872E4DC0AB006A60324B41C0E7029A97872E4DC034CE659E324B41C00833F158872E4DC09B4507D1324B41C0202F0012872E4DC0FAC8A7E7324B41C01A0F22D1862E4DC03E6CDEE9324B41C08D84795E862E4DC07EA6C0E6324B41C0C2ADC4DC852E4DC0BDBD85D7324B41C023346541852E4DC029B690CD324B41C083A40410092E4DC094D1CEDE284B41C043D25469082E4DC09A8208CE284B41C0C1170ADD072E4DC097A166CC284B41C0C71B616D072E4DC0669FACDA284B41C07148EA1E072E4DC0379C12F5284B41C01AA93BDA062E4DC007364110294B41C0A531C694062E4DC05B82523E294B41C06FF92159062E4DC0A1563270294B41C03265DC31062E4DC0637B0299294B41C03BF6A416062E4DC0E80124CA294B41C0A2C00FF0052E4DC05070131E2A4B41C00E2419E0052E4DC0234468832A4B41C08CE863CC052E4DC0867623DB2A4B41C07D4030A7022E4DC0173B4E33464B41C0371797C1022E4DC0162D9F38464B41C0C75FBDDC022E4DC0051AEF3D464B41C059E5E3F7022E4DC09C6F7E42464B41C02D054512032E4DC03A60CF47464B41C0CD8A6B2D032E4DC0B9B55E4C464B41C018D39148032E4DC0F2D0AF51464B41C0C458B863032E4DC05C263F56464B41C075DEDE7E032E4DC0B77BCE5A464B41C02C64059A032E4DC006D15D5F464B41C0C58BECB5032E4DC0D015AF64464B41C08A1113D1032E4DC0066B3E69464B41C0539739EC032E4DC030C0CD6D464B41C0188D1F08042E4DC0A9F86172464B41C0EB124623042E4DC0BC4DF176464B41C0CA986C3E042E4DC0C3A2807B464B41C089C0535A042E4DC041E7D180464B41C071467A75042E4DC02F3C6185464B41C0D33D6091042E4DC080BAF089464B41C0C7C386AC042E4DC0550F808E464B41C0F3286EC8042E4DC0DE8D0F93464B41C0F3AE94E3042E4DC09CE29E97464B41C0FB34BBFE042E4DC04E372E9C464B41C07A2CA11A052E4DC060B5BDA0464B41C08EB2C735052E4DC0F9094DA5464B41C0D817AF51052E4DC04388DCA9464B41C0F59DD56C052E4DC0C3DC6BAE464B41C0CCE6FB87052E4DC0F9F6BCB3464B41C0F76C22A3052E4DC0634B4CB8464B41C07E6308BF052E4DC09654DFBC464B41C0B4E92EDA052E4DC0E5A86EC1464B41C0A53255F5052E4DC0EEC2BFC6464B41C0E8B87B10062E4DC026174FCB464B41C0323FA22B062E4DC0506BDECF464B41C03588C846062E4DC035852FD5464B41C08B0EEF61062E4DC047D9BED9464B41C0EC9C517C062E4DC0BAC80FDF464B41C004E67797062E4DC079E260E4464B41C0F7FADEB1062E4DC0000DF0E8464B41C01E4405CD062E4DC0AA2641EE464B41C016AE6AE7062E4DC08A1692F3464B41C09A3CCD01072E4DC0C505E3F8464B41C080A5321C072E4DC0FE8037FE464B41C013349536072E4DC021708803474B41C0450CFC50072E4DC0AD31D808474B41C05D76616B072E4DC05921290E474B41C0D0250385072E4DC0A2E67913474B41C0FB4EAA9E072E4DC0E5728C19474B41C0EE6F0BB9072E4DC07F61DD1E474B41C06A2BB1D2072E4DC05DEDEF24474B41C0D20B54EC072E4DC0174A012B474B41C030DC3405082E4DC076E55130474B41C07D05DC1E082E4DC082716436474B41C0A998BC37082E4DC093D2763C474B41C079989E50082E4DC052BF8C42474B41C08D5C8069082E4DC0E9B75F49474B41C0C3A66682082E4DC0191A724F474B41C07A42839A082E4DC0FBE74456474B41C0264556AA082E4DC0128EA061474B41C09B2DD4AB082E4DC0A3C9CD76474B41C0E61643A4082E4DC011A74691474B41C06BC4679A082E4DC0F6053FAD474B41C06C845B94082E4DC018A0F7C6474B41C0CD585494082E4DC0B4E4A6DD474B41C0499E0C95082E4DC02B8157F4474B41C03EC28596082E4DC04AA40A0B484B41C05E453E97082E4DC0844CF820484B41C04FB3BB98082E4DC09E13A937484B41C0CC657599082E4DC0550D5C4E484B41C02529F19A082E4DC0696BCD65484B41C0C4DCAA9B082E4DC0B4D97C7C484B41C02521639C082E4DC099013193484B41C0FAABA19E082E4DC025FE1EA9484B41C09942DAA0082E4DC036BFCEBF484B41C08C4ADCA3082E4DC051DA7FD6484B41C087EB58A8082E4DC035A433ED484B41C05DF39AAD082E4DC087472203494B41C04273D8B2082E4DC09669D719494B41C0227B1AB8082E4DC0E80CC62F494B41C089669BBC082E4DC04D4C7646494B41C0BD23D9C1082E4DC096A8695C494B41C0AC9D9AC5082E4DC094BE1973494B41C067CE57C9082E4DC0A6D3C989494B41C0261AD6CD082E4DC08C06BD9F494B41C0A60557D2082E4DC0ED456DB6494B41C08DEC59D8082E4DC066415DCC494B41C081D61ADF082E4DC0E5C24FE2494B41C07357A2E6082E4DC05D1240F8494B41C09AD0E3EE082E4DC0BF956D0D4A4B41C023C32AF7082E4DC0960E5E234A4B41C0748470FF082E4DC04F1E8F384A4B41C094E87608092E4DC087C07F4E4A4B41C03B897D11092E4DC0ECF9B0634A4B41C06CED831A092E4DC0219CA1794A4B41C0458F8A23092E4DC0194ACF8E4A4B41C0A82F912C092E4DC0F3B101A44A4B41C07AB05836092E4DC010B830B94A4B41C0F5C31E40092E4DC0648F5ECE4A4B41C0DA44E649092E4DC07E958DE34A4B41C06C7F7154092E4DC05151C0F84A4B41C01321B85F092E4DC0EBB52C0D4B4B41C064CE026B092E4DC0AE0F5C224B4B41C0DAB74D76092E4DC0192FCD364B4B41C026825982092E4DC04ABE394B4B4B41C01C4C658E092E4DC0F27BA75F4B4B41C040A76F9A092E4DC0B6C418744B4B41C04F717BA6092E4DC0578286884B4B41C030EA46B3092E4DC096A3329C4B4B41C0119791BE092E4DC03A5A64B14B4B41C043619DCA092E4DC0D717D2C54B4B41C0802BA9D6092E4DC06FD53FDA4B4B41C0EC86B3E2092E4DC0251EB1EE4B4B41C0B3DF3FF0092E4DC0893A5C024C4B41C0273090FE092E4DC0ECE946154C4B41C0BAF09F0D0A2E4DC0907C36284C4B41C05DCF701D0A2E4DC033B95F3A4C4B41C09F1F012E0A2E4DC0321F894C4C4B41C07298563F0A2E4DC0C6AFB25E4C4B41C072E0AA500A2E4DC0BCA81B704C4B41C0444CFC610A2E4DC001FE86814C4B41C0895750730A2E4DC03A8EB0934C4B41C0E39BE6830A2E4DC0115E19A54C4B41C00A5E36950A2E4DC051ED42B74C4B41C04F138CA60A2E4DC07243AEC84C4B41C066C9E1B70A2E4DC0993C17DA4C4B41C079F1F6C90A2E4DC09F307FEB4C4B41C052550CDC0A2E4DC0BE182AFC4C4B41C04B2CE1EE0A2E4DC05270D00C4D4B41C07A1F77020B2E4DC03E5AB61C4D4B41C0F25B11160B2E4DC014459C2C4D4B41C0E4FC662A0B2E4DC0F91DC43B4D4B41C0A1E8C03E0B2E4DC0DC3DE74A4D4B41C05CB3DB530B2E4DC0DFB50B5A4D4B41C00ADC35680B2E4DC06C3E6E684D4B41C0A95D4C7D0B2E4DC070B592774D4B41C02148A6910B2E4DC01F8FBA864D4B41C04D50C1A60B2E4DC042411D954D4B41C0C8EADABB0B2E4DC00AF37FA34D4B41C00EF3F5D00B2E4DC01EA5E2B14D4B41C0FA6CD0E60B2E4DC0818045C04D4B41C03860ABFC0B2E4DC0C15B28CD4D4B41C09F3F4B130C2E4DC060CACADA4D4B41C0ABA5E5290C2E4DC07E43AAE74D4B41C0B3B681400C2E4DC01CF7C7F34D4B41C03A82E1570C2E4DC07103E7FF4D4B41C074FB00700C2E4DC0BCFE470B4E4B41C06AB320880C2E4DC0567AE2154E4B41C0C5D841A00C2E4DC0B0247E204E4B41C0F5AC22B90C2E4DC09032582A4E4B41C09F5002D20C2E4DC0547A70334E4B41C01F6EE7EA0C2E4DC00E894A3D4E4B41C07D7EC8030D2E4DC0785C66464E4B41C09E01691D0D2E4DC0C3CD7E4F4E4B41C0D0124A360D2E4DC0274498584E4B41C0A2E72A4F0D2E4DC0512371624E4B41C0284210680D2E4DC08D9A8A6B4E4B41C075C5B0810D2E4DC0AE0BA3744E4B41C04D2C909A0D2E4DC0E3187D7E4E4B41C0173E71B30D2E4DC09B6095874E4B41C0CE4E52CC0D2E4DC0B333B1904E4B41C0821BF7E50D2E4DC093A5C9994E4B41C0531998FF0D2E4DC0FA8A5EA14E4B41C0C7CD3E190E2E4DC006A0F4A84E4B41C06E7A9F330E2E4DC0E3E8C7AF4E4B41C0FF57064E0E2E4DC0E3D518B54E4B41C0B48A6B680E2E4DC049882BBB4E4B41C0EDD991830E2E4DC0829E7CC04E4B41C07EABF49D0E2E4DC0AEC40BC54E4B41C0EA371BB90E2E4DC00A159BC94E4B41C09D1582D30E2E4DC0CE01ECCE4E4B41C0F3A0A8EE0E2E4DC07EDD7ED34E4B41C02A5096100F2E4DC092F554DA4E4B41C097F2B0C12F2E4DC09CB4BAAD554B41C03EF517B72F2E4DC0341404D2554B41C08C35F425302E4DC0A65B9DEF554B41C0F14C56242F2E4DC0A1F73590594B41C0BA4161B42E2E4DC0BE5CACA25A4B41C06A96DC2B2E2E4DC019A2F1945A4B41C0594070202E2E4DC08D8E27EB5A4B41C036B98F9A2E2E4DC07D9E86285B4B41C0DEFE5FBC2C2E4DC01173A641624B41C0F91BDDCB2D2E4DC058EA8771624B41C055C0743E302E4DC0B963B692594B41C0620EA531312E4DC03EF48A25564B41C0634E9F84312E4DC04BADB631564B41C08A5D0499312E4DC01ACEAE0F564B41C0B3126D88422E4DC043493A88594B41C0A3B048DCBE2E4DC066C140E4724B41C029C490561A2F4DC0DE3A1A64854B41C0D4EA9260182F4DC0404B68A7934B41C080711D280B2F4DC00CCA0DBF9A4B41C045E9589A0A2F4DC00AFCE99C9A4B41C0D51C57100A2F4DC0E1D559859A4B41C065175586092F4DC0ADFF8E6E9A4B41C07B068DFB082F4DC068E9C95A9A4B41C0ED120570082F4DC0C4AB84489A4B41C089077BE4072F4DC0CA1A87389A4B41C00EF9F158072F4DC063140D2A9A4B41C05217ADCC062F4DC09538D81D9A4B41C00B199E3F062F4DC00956E7139A4B41C0496652B3052F4DC066F6780B9A4B41C069964626052F4DC0F5EE50059A4B41C05991F999042F4DC0717568019A4B41C0A823E80C042F4DC0166ACDFF994B41C0428FDA7F032F4DC0F02FB1FF994B41C01852CCF2022F4DC0E38BD5019A4B41C01A58B965022F4DC0108884059A4B41C014286FD9012F4DC02971750B9A4B41C0086D594C012F4DC02653AA139A4B41C03D9F09C0002F4DC0EDAC241E9A4B41C0E4F1B733002F4DC0AB90222A9A4B41C0F87A26A8FF2E4DC095BC64389A4B41C0A458941CFF2E4DC07B95EE489A4B41C03F0E0691FE2E4DC08E9CF95A9A4B41C05E433206FE2E4DC039BC476F9A4B41C06288217CFD2E4DC0110DE0859A4B41C00A810DF2FC2E4DC0BC2DF79D9A4B41C0288BBC68FC2E4DC0409752B89A4B41C0DE4B30E0FB2E4DC0073E35D49A4B41C055AB9D57FB2E4DC051A859F29A4B41C0BAFB8ED0FA2E4DC0A10DC6129B4B41C017FF7C49FA2E4DC04671B2349B4B41C02685EDC3F92E4DC02EFEE7589B4B41C0EB995D3EF92E4DC08C5B9C7E9B4B41C03FBE90B9F82E4DC0C9BB99A69B4B41C0B4F84436F82E4DC0258BDBD09B4B41C05234B8B3F72E4DC0F67F9DFC9B4B41C0536FEA31F72E4DC09982E5299C4B41C0B8BBDFB0F62E4DC058716F599C4B41C08F555631F62E4DC079C3808A9C4B41C0F9FF8FB2F52E4DC0B45ED6BD9C4B41C0098B4935F52E4DC0AFD1AFF29C4B41C0F4DCC1B8F42E4DC06ABBCE299D4B41C0115ABE3DF42E4DC0EAC36C629D4B41C0A18C75C3F32E4DC00508929C9D4B41C03332B54AF32E4DC0B5253BD89D4B41C045C3B0D2F22E4DC0338B28169E4B41C04E3AF45CF22E4DC0DDF099559E4B41C0022FF2E7F12E4DC0169E4F979E4B41C09BCF7874F12E4DC0455FC7D99E4B41C03FCE7A02F12E4DC05FBD841E9F4B41C0CFF60092F02E4DC0E8C5C4649F4B41C0EC480B23F02E4DC064A788AC9F4B41C08A0D94B5EF2E4DC0B660D0F59F4B41C0532FA249EF2E4DC080446141A04B41C016FF2EDFEE2E4DC01CF5AB8DA04B41C0FEAC3B76EE2E4DC0C79481DBA04B41C0DAF88B0FEE2E4DC0377AD62AA14B41C0183560AAED2E4DC091FE707CA14B41C0E7D3B846ED2E4DC05296CDCEA14B41C097088DE4EC2E4DC0F990B122A24B41C08324A984EC2E4DC06AD21478A24B41C003EC4326EC2E4DC037263ACEA24B41C06FF124CAEB2E4DC0ABCBA826A34B41C01536836FEB2E4DC05DC9D47FA34B41C0F9116716EB2E4DC0AEA084DAA34B41C071898EBFEA2E4DC06E03BC36A44B41C041FCF66AEA2E4DC07414B293A44B41C04D9DA118EA2E4DC035822EF2A44B41C07E58CCC7E92E4DC0DFA56A51A54B41C0F03D7B78E92E4DC0164628B2A54B41C0DBD82E2CE92E4DC08601AD13A64B41C0255660DEE82E4DC023E33A7BA64B41C041057898BE2E4DC0B92E12AAE64B41C021694FE3B92E4DC004A32C51ED4B41C05D2F8C00A42E4DC096E74E970E4C41C0A18FC0F9A32E4DC0298067A30E4C41C010A5F8F5A32E4DC0670939AA0E4C41C062E02DF2A32E4DC02AD805B10E4C41C0322A67EEA32E4DC0029C95B80E4C41C0D0AEA0EAA32E4DC0A56B62BF0E4C41C01333DAE6A32E4DC0C26930C60E4C41C05E6E0FE3A32E4DC08438FDCC0E4C41C09CF248DFA32E4DC09F36CBD30E4C41C0357782DBA32E4DC0420698DA0E4C41C071FBBBD7A32E4DC05F0466E10E4C41C034B9B4D4A32E4DC01E7BF9E80E4C41C07BF4E9D0A32E4DC0DD49C6EF0E4C41C0B27823CDA32E4DC0F84794F60E4C41C052721CCAA32E4DC0183F61FD0E4C41C015BC55C6A32E4DC0EB02F1040F4C41C0B2B54EC3A32E4DC00AFABD0B0F4C41C0E73988BFA32E4DC025F88B120F4C41C0D66682BCA32E4DC04AB51A1A0F4C41C013607BB9A32E4DC0E3DAE8200F4C41C0415874B6A32E4DC0E48BBA270F4C41C03D866EB3A32E4DC09EBD452F0F4C41C05A09A8AFA32E4DC0214717360F4C41C02E7F9CACA32E4DC01603A63D0F4C41C0B7C199A9A32E4DC08F2974440F4C41C0102994A6A32E4DC0FB20414B0F4C41C0E35C4CA4A32E4DC0C833D1520F4C41C03DC446A1A32E4DC0322B9E590F4C41C0FE823F9EA32E4DC080162E610F4C41C08E7C389BA32E4DC09E0DFB670F4C41C0121DF298A32E4DC024AC8E6F0F4C41C02DDCEA95A32E4DC0F9681D770F4C41C034B8A493A32E4DC059B6EB7D0F4C41C04E779D90A32E4DC02E737A850F4C41C0A19C5B8EA32E4DC070C1488C0F4C41C07EC9558BA32E4DC0917ED7930F4C41C0A4FD0D89A32E4DC0E762669B0F4C41C0A6D9C786A32E4DC045B034A20F4C41C08F7B8184A32E4DC0E694C3A90F4C41C0BB747A81A32E4DC079BA91B00F4C41C0845E387FA32E4DC0DF5925B80F4C41C06C00F27CA32E4DC07F3EB4BF0F4C41C0A76EAA7AA32E4DC0948B82C60F4C41C08B106478A32E4DC0307011CE0F4C41C0D070E176A32E4DC0317DA0D50F4C41C059129B74A32E4DC0499030DD0F4C41C0B2EE5472A32E4DC02EAFFDE30F4C41C087D91270A32E4DC029C38DEB0F4C41C068EF8B6EA32E4DC0B45A20F30F4C41C04EDB496CA32E4DC040E3ACFA0F4C41C0A42BC36AA32E4DC011B57D01104C41C0625F7B68A32E4DC0DFC70D09104C41C0672DFA66A32E4DC027D59C10104C41C02561B264A32E4DC0F4E72C18104C41C0282F3163A32E4DC03EF5BB1F104C41C01746AA61A32E4DC05A014B27104C41C01E972360A32E4DC03876192E104C41C0EEF5A05EA32E4DC01D3DAD35104C41C0DE0C1A5DA32E4DC03B493C3D104C41C0196D975BA32E4DC03856CB44104C41C0BD3A165AA32E4DC0FD915B4C104C41C0AB518F58A32E4DC01B9EEA53104C41C039680857A32E4DC0AED87A5B104C41C0E8028655A32E4DC0F51F4862104C41C09E45C454A32E4DC03883D869104C41C0885C3D53A32E4DC0538F6771104C41C067307A52A32E4DC0B87DFB78104C41C09F90F750A32E4DC0B78A8A80104C41C0058A3150A32E4DC018ED1A88104C41C03DEAAE4EA32E4DC015FAA98F104C41C0FEE3E84DA32E4DC0FE2D3997104C41C0EDB8254DA32E4DC0F390C99E104C41C0E786A44BA32E4DC03D9E58A6104C41C0D85BE14AA32E4DC03401E9AD104C41C096551B4AA32E4DC01C3578B5104C41C074295849A32E4DC07E230CBD104C41C0826C9648A32E4DC04B589BC4104C41C0CB41D347A32E4DC0C88C2ACC104C41C02F3B0D47A32E4DC027EFBAD3104C41C052F30A47A32E4DC06F4B4ADB104C41C07A704946A32E4DC0F9E818E2104C41C0C0458645A32E4DC0781DA8E9104C41C08AFD8345A32E4DC039A838F1104C41C09640C244A32E4DC002DDC7F8104C41C021CBFA43A32E4DC082CA5B00114C41C04583F843A32E4DC0CC26EB07114C41C0683BF643A32E4DC015837A0F114C41C0197E3443A32E4DC059E60A17114C41C03A363243A32E4DC0A0429A1E114C41C002EE2F43A32E4DC064CD2A26114C41C026A62D43A32E4DC0AC29BA2D114C41C0485E2B43A32E4DC0F4854935114C41C010162943A32E4DC0B610DA3C114C41C01FCD2643A32E4DC06BF86C44114C41C0E7842443A32E4DC02B83FD4B114C41C00B3D2243A32E4DC074DF8C53114C41C0D3F41F43A32E4DC0366A1D5B114C41C0F5AC1D43A32E4DC07EC6AC62114C41C031DADA43A32E4DC0464A3C6A114C41C0F991D843A32E4DC009D5CC71114C41C01D4AD643A32E4DC051315C79114C41C0102E9944A32E4DC0C0E4EC80114C41C03B5A5645A32E4DC0F5F37F88114C41C003125445A32E4DC0B87E1090114C41C005AD1246A32E4DC0C902A097114C41C0E6D9CF46A32E4DC00CB5309F114C41C00892CD46A32E4DC05411C0A6114C41C096088F47A32E4DC0FD954FAE114C41C03DA34D48A32E4DC08C48E0B5114C41C07BD00A49A32E4DC052CC6FBD114C41C0226BC949A32E4DC0E17E00C5114C41C09FE08A4AA32E4DC0F58E93CC114C41C0477B494BA32E4DC0844124D4114C41C0A21DC64CA32E4DC0C9ECB3DB114C41C0A4B8844DA32E4DC0DE7043E3114C41C0D82E464EA32E4DC00024D4EA114C41C0FA3EC44FA32E4DC092CF63F2114C41C02CB58550A32E4DC0B782F4F9114C41C04EC50352A32E4DC0492E8401124C41C0E65EC252A32E4DC0406C1809124C41C0CCF24454A32E4DC0FE52E60F124C41C0B11F0255A32E4DC040057717124C41C0D52F8056A32E4DC0D0B0061F124C41C049890258A32E4DC0465D9626124C41C05FE28459A32E4DC03438272E124C41C0BF84015BA32E4DC07BE3B635124C41C08A947F5CA32E4DC086BD473D124C41C0FEED015EA32E4DC0FA69D744124C41C03C38805FA32E4DC04E7EA64B124C41C0A0900261A32E4DC02DB63953124C41C0BBE98462A32E4DC01C91CA5A124C41C0016FC264A32E4DC02D645A62124C41C01CC84466A32E4DC01D3FEB69124C41C0806AC167A32E4DC063EA7A71124C41C04FE1046AA32E4DC0E6F84878124C41C06E3A876BA32E4DC0D5D3D97F124C41C0B6BFC46DA32E4DC0E7A66987124C41C0F28D0670A32E4DC051A9FA8E124C41C027D78471A32E4DC01149CD95124C41C0C1A5C673A32E4DC0021D5D9D124C41C05B740876A32E4DC0F5F0ECA4124C41C061B04B78A32E4DC0ACF37DAC124C41C03E8DC879A32E4DC039D94BB3124C41C044C90B7CA32E4DC0F1DBDCBA124C41C0E1974D7EA32E4DC0E4AF6CC2124C41C04A578B80A32E4DC0B4EB3BC9124C41C0CE088E83A32E4DC070E7CBD0124C41C000D6CF85A32E4DC0487560D8124C41C018DF1188A32E4DC07F832EDF124C41C0231B558AA32E4DC03886BFE6124C41C05899568DA32E4DC0EEBB8DED124C41C0511E948FA32E4DC078BD1EF5124C41C0DACF9692A32E4DC034B9AEFC124C41C09AD8D894A32E4DC0E5F57D03134C41C0238ADB97A32E4DC0A1F10D0B134C41C0E3921D9AA32E4DC0552EDD11134C41C05F43209DA32E4DC07AB57019134C41C0052F23A0A32E4DC0F6194020134C41C0CF7224A3A32E4DC06315D027134C41C0795E27A6A32E4DC0DE799F2E134C41C009102AA9A32E4DC09B752F36134C41C0EF8D2BACA32E4DC0CAD9FE3C134C41C0823F2EAFA32E4DC084D58E44134C41C02F2B31B2A32E4DC0FF395E4B134C41C074A932B5A32E4DC0B46F2C52134C41C0AE5A35B8A32E4DC0E799BD59134C41C0AA4538BBA32E4DC0525B8F60134C41C07BA6FABEA32E4DC04AE75E67134C41C050EAFBC1A32E4DC0B9E2EE6E134C41C0254BBEC5A32E4DC0B06EBE75134C41C0D936C1C8A32E4DC02AD38D7C134C41C09A5D83CCA32E4DC060F61D84134C41C0504986CFA32E4DC0DA5AED8A134C41C0D2F34CD3A32E4DC03AB9BB91134C41C089DF4FD6A32E4DC0B21D8B98134C41C03D0512DAA32E4DC053CC1EA0134C41C01B66D4DDA32E4DC04958EEA6134C41C055C796E1A32E4DC0C5B5BCAD134C41C083715DE5A32E4DC09D428CB4134C41C064D21FE9A32E4DC093CE5BBB134C41C0A333E2ECA32E4DC00D2C2AC2134C41C08594A4F0A32E4DC002B8F9C8134C41C0143F6BF4A32E4DC05F16C8CF134C41C0C20D2FF8A32E4DC09EA297D6134C41C0B8E2B0FCA32E4DC07CE16ADD134C41C0FC437300A42E4DC0F83E39E4134C41C034EE3904A42E4DC0CCCB08EB134C41C06532BD08A42E4DC01051D7F1134C41C051937F0CA42E4DC002DDA6F8134C41C00EB30511A42E4DC0DA6275FF134C41C0FD13C814A42E4DC0CCEE4406144C41C026A14F19A42E4DC069A3140D144C41C07102121DA42E4DC0E300E313144C41C0FB129421A42E4DC099EEF019144C41C0169F1B26A42E4DC0A12EC420144C41C08E759D2AA42E4DC094B39227144C41C0BE02252FA42E4DC02F68622E144C41C04B13A733A42E4DC0E3557034144C41C0DBA02E38A42E4DC005DC3E3B144C41C0FA76B03CA42E4DC0718F0E42144C41C0FD3E3841A42E4DC0D74F1B48144C41C02015BA45A42E4DC04303EB4E144C41C0B5A2414AA42E4DC06589B955144C41C049B3C34EA42E4DC01877C75B144C41C0AEB50A54A42E4DC02B539762144C41C0F9328E58A42E4DC094CCA868144C41C0CE52145DA42E4DC06852776F144C41C0A38F5B62A42E4DC0C1688575144C41C097D3DE66A42E4DC0771C557C144C41C0CD10266CA42E4DC057046282144C41C03A136D71A42E4DC06AE03189144C41C0DA23EF75A42E4DC017CE3F8F144C41C01661367BA42E4DC0F5B54C95144C41C085637D80A42E4DC009921C9C144C41C02B74FF84A42E4DC0B57F2AA2144C41C0FDAF468AA42E4DC079213CA8144C41C03CED8D8FA42E4DC0560949AE144C41C0D4E0D094A42E4DC0CA1E57B4144C41C04CE3179AA42E4DC0D9FA26BB144C41C092205F9FA42E4DC0B4E233C1144C41C02F14A2A4A42E4DC029F841C7144C41C01B51E9A9A42E4DC07C0E50CD144C41C08B03F0AFA42E4DC0D21D5DD3144C41C07B4037B5A42E4DC025346BD9144C41C06E7D7EBAA42E4DC0794A79DF144C41C01071C1BFA42E4DC0E75F87E5144C41C01D22C8C5A42E4DC0212999EB144C41C06C5F0FCBA42E4DC0F910A6F1144C41C0507F17D1A42E4DC0104FB4F7144C41C04CBC5ED6A42E4DC06065C2FD144C41C0DCA865DCA42E4DC071DD0E03154C41C0E49CA8E1A42E4DC064C41B09154C41C00C4FAFE7A42E4DC02F022A0F154C41C04AB8BBEDA42E4DC025413815154C41C0A478FDF2A42E4DC08C90841A154C41C0F19805F9A42E4DC026A09120154C41C01E4B0CFFA42E4DC0EDDD9F26154C41C0A9361305A52E4DC067E1EF2B154C41C09F561B0BA52E4DC0781FFE31154C41C040432211A52E4DC084974A37154C41C074F52817A52E4DC04AD5583D154C41C03950311DA52E4DC0261FA442154C41C070023823A52E4DC0E95CB248154C41C017EF3E29A52E4DC0F5D4FE4D154C41C0170F472FA52E4DC001130D54154C41C0C0FB4D35A52E4DC00B8B5959154C41C05CCB153CA52E4DC0D72AA65E154C41C062B81C42A52E4DC06574F163154C41C06DD82448A52E4DC070B2FF69154C41C03539EB4EA52E4DC05CDD4F6F154C41C0AB93F354A52E4DC0AD559C74154C41C09EACBF5BA52E4DC05AF6E879154C41C00450C261A52E4DC07C6D357F154C41C0F9688E68A52E4DC0260E8284154C41C0B255956EA52E4DC02A86CE89154C41C05A255D75A52E4DC0EF251B8F154C41C09C87237CA52E4DC0F2966694154C41C04A57EB82A52E4DC0B636B399154C41C01DFBF788A52E4DC0E3AFFF9E154C41C0095DBE8FA52E4DC05D4F4CA4154C41C0BC2C8696A52E4DC020EF98A9154C41C070FC4D9DA52E4DC0E28EE5AE154C41C0BA9714A4A52E4DC00AF473B3154C41C0C1B0E0AAA52E4DC0AD94C0B8154C41C07B80A8B1A52E4DC06E340DBE154C41C09F8A70B8A52E4DC0730E98C2154C41C096EC36BFA52E4DC0E7ADE4C7154C41C0A60503C6A52E4DC0884E31CD154C41C0CE0FCBCCA52E4DC08A28BCD1154C41C0BE5452D4A52E4DC0BDEF08D7154C41C0EB5E1ADBA52E4DC0C2C993DB154C41C069B2E6E1A52E4DC0A5A41EE0154C41C05CF76DE9A52E4DC0D66B6BE5154C41C0DD4A3AF0A52E4DC0B846F6E9154C41C0E2AC00F7A52E4DC024E642EF154C41C00B9A89FEA52E4DC0E6E7CDF3154C41C07A365005A62E4DC097C158F8154C41C0E36BDD0CA62E4DC0A74FE7FC154C41C05708A413A62E4DC056297201164C41C0D53E311BA62E4DC0F72BFD05164C41C0D583B822A62E4DC020F3490B164C41C051207F29A62E4DC0CFCCD40F164C41C0D1560C31A62E4DC06CCF5F14164C41C0A7109438A62E4DC0210B2918164C41C025AD5A3FA62E4DC0CDE4B31C164C41C0ACE3E746A62E4DC067E73E21164C41C01F636F4EA62E4DC0D5E8C925164C41C0E52BFB55A62E4DC020EB542A164C41C0EEA9825DA62E4DC070A6E42E164C41C030AE0E65A62E4DC09757AA32164C41C0AA2D966CA62E4DC0FD583537164C41C03C642374A62E4DC0925BC03B164C41C00D1DAB7BA62E4DC0AE228D3F164C41C0DBE53683A62E4DC0F3241844164C41C0C19FBE8AA62E4DC09F60E147164C41C095684A92A62E4DC0E5626C4C164C41C0E68FD399A62E4DC053CD3650164C41C0EBCD1EA2A62E4DC00DF7C154164C41C0D787A6A9A62E4DC0B2328B58164C41C0DBF833B1A62E4DC08A6F545C164C41C06578BBB8A62E4DC0E670DF60164C41C0D5F006C1A62E4DC0DFD4A864164C41C0816194C8A62E4DC02D407368164C41C0741B1CD0A62E4DC0D07B3C6C164C41C0E99367D8A62E4DC0C7DF0570164C41C0E04DEFDFA62E4DC0691BCF73164C41C0AD323CE8A62E4DC090399D77164C41C0A7ECC3EFA62E4DC02F75667B164C41C0E7D210F8A62E4DC06ED92F7F164C41C0E38C98FFA62E4DC00C15F982164C41C06205E407A72E4DC00079C286164C41C048EB3010A72E4DC0B10B8D8A164C41C04AA5B817A72E4DC04F47568E164C41C0F2C50520A72E4DC0CFE55D91164C41C0763E5128A72E4DC0BE492795164C41C020F8D82FA72E4DC0CCB3F198164C41C0CC182638A72E4DC04B52F99B164C41C01AFF7240A72E4DC07FB6C29F164C41C005B2BE48A72E4DC0B054CAA2164C41C0AA4E0751A72E4DC07DE694A6164C41C05D6F5459A72E4DC0F5849CA9164C41C0CA63DC60A72E4DC0CDFAA3AC164C41C0FFDB2769A72E4DC02D8D6EB0164C41C0B6FC7471A72E4DC0A42B76B3164C41C0001CC279A72E4DC0FE8382B6164C41C0B5860982A72E4DC0D79586B9164C41C0106D568AA72E4DC003FA4FBD164C41C09A1EA292A72E4DC00E525CC0164C41C098B5AE9BA72E4DC0848C60C3164C41C0F68BF7A3A72E4DC07FB56BC6164C41C0953E43ACA72E4DC01A8274C9164C41C0575F90B4A72E4DC089207CCC164C41C01980DDBCA72E4DC0F1BE83CF164C41C0CC2325C5A72E4DC0F2C4CAD1164C41C0C2B931CEA72E4DC0CC8AD2D4164C41C02CDA7ED6A72E4DC0AF57DBD7164C41C02C8DCADEA72E4DC0C9F5E2DA164C41C0069F13E7A72E4DC096CD28DD164C41C0A43420F0A72E4DC0E5C131E0164C41C0CE8F6DF8A72E4DC08E9A77E2164C41C07842B900A82E4DC0226780E5164C41C0D612C609A82E4DC03C67C6E7164C41C0FAE90E12A82E4DC03033CFEA164C41C061D75A1AA82E4DC08D0B15ED164C41C067A76723A82E4DC01D3A5CEF164C41C037C8B42BA82E4DC079D863F2164C41C09B98C134A82E4DC08CD8A9F4164C41C071F30E3DA82E4DC0A8DFF0F6164C41C06AC21B46A82E4DC09D993BF9164C41C0C47CA311AB2E4DC050E89527184C41C0A27BB21DAB2E4DC01129672E184C41C0FBFB3925AB2E4DC0E429F232184C41C0BE6DC72CAB2E4DC02C66BB36184C41C01AEE4E34AB2E4DC0FB66463B184C41C0C9A8D63BAB2E4DC012A20F3F184C41C079726243AB2E4DC0C4A39A43184C41C00B58AF4BAB2E4DC051C16847184C41C06ED83653AB2E4DC01DC2F34B184C41C085DDC25AAB2E4DC0A772B94F184C41C029974A62AB2E4DC025398653184C41C02E7E976AAB2E4DC0C89C4F57184C41C097FE1E72AB2E4DC0929DDA5B184C41C09EE56B7AAB2E4DC03401A45F184C41C000A0F381AB2E4DC0BA6A6E63184C41C00DA47F89AB2E4DC0ABA63767184C41C0188BCC91AB2E4DC04B0A016B184C41C012BB139AAB2E4DC0BC6CCA6E184C41C015F99FA1AB2E4DC06811D371184C41C027E0ECA9AB2E4DC004759C75184C41C039C739B2AB2E4DC09FD86579184C41C0FF81C1B9AB2E4DC0A6132F7D184C41C043350DC2AB2E4DC0B5DF3780184C41C008D355CAAB2E4DC069420184184C41C0A786A1D2AB2E4DC0FCDF0887184C41C01BF72EDAAB2E4DC010D6D68A184C41C0806276E2AB2E4DC054E7DA8D184C41C0D882C3EAAB2E4DC09A10E690184C41C0D5FB0EF3AB2E4DC05BA2B094184C41C0F3D357FBAB2E4DC0503FB897184C41C05EF5A403AC2E4DC026DDBF9A184C41C0ADA8F00BAC2E4DC02DA9C89D184C41C0CC803914AC2E4DC01E46D0A0184C41C07634851CAC2E4DC0A7E3D7A3184C41C08F55D224AC2E4DC0F1AFE0A6184C41C03CECDE2DAC2E4DC02675E8A9184C41C0AF0D2C36AC2E4DC0F812F0AC184C41C0B477733EAC2E4DC012DEF8AF184C41C02B99C046AC2E4DC0DF7B00B3184C41C0CF69CD4FAC2E4DC0D0A947B5184C41C0821D1958AC2E4DC051474FB8184C41C0ADF56160AC2E4DC03AE456BB184C41C053C66E69AC2E4DC025129EBD184C41C00A7ABA71AC2E4DC0A2AFA5C0184C41C078D5077AAC2E4DC029B6ECC2184C41C07BA61483AC2E4DC09AB532C5184C41C09FC7618BAC2E4DC0D8813BC8184C41C0A5986E94AC2E4DC0468181CA184C41C0013DB69CAC2E4DC09886C8CC184C41C09E0CC3A5AC2E4DC0E93F13CF184C41C07D6910AEAC2E4DC0848C55D1184C41C01C391DB7AC2E4DC0D245A0D3184C41C0FC956ABFAC2E4DC06992E2D5184C41C09B6577C8AC2E4DC0B64B2DD8184C41C0A83684D1AC2E4DC0184B73DA184C41C00ADBCBD9AC2E4DC06550BADC184C41C061E6D8E2AC2E4DC00E8A3EDE184C41C0DA4126EBAC2E4DC0879085E0184C41C0EB1233F4AC2E4DC0E58FCBE2184C41C0EB1D40FDAC2E4DC002F850E4184C41C0A1EE4C06AD2E4DC0D92598E6184C41C0FC16990EAD2E4DC0CF371CE8184C41C0FB21A617AD2E4DC0E99FA1E9184C41C012F3B220AD2E4DC0419FE7EB184C41C012FEBF29AD2E4DC058076DED184C41C01509CD32AD2E4DC06E6FF2EE184C41C07414DA3BAD2E4DC007A976F0184C41C0EE602344AD2E4DC0DBE8FBF1184C41C0F36B304DAD2E4DC0EE5081F3184C41C0F8763D56AD2E4DC0FEB806F5184C41C059824A5FAD2E4DC094F28AF6184C41C0608D5768AD2E4DC0A35A10F8184C41C067986471AD2E4DC0AFC295F9184C41C00FDE717AAD2E4DC0883658FA184C41C018E97E83AD2E4DC0929EDDFB184C41C021F48B8CAD2E4DC09A0663FD184C41C072399995AD2E4DC0EBA826FE184C41C0D644A69EAD2E4DC078E2AAFF184C41C0298AB3A7AD2E4DC0C2846E00194C41C076CFC0B0AD2E4DC00E273201194C41C082DACDB9AD2E4DC00F8FB702194C41C02F20DBC2AD2E4DC0DF027A03194C41C08165E8CBAD2E4DC024A53D04194C41C0D2AAF5D4AD2E4DC06B470105194C41C025F002DEAD2E4DC0ADE9C405194C41C0783510E7AD2E4DC0F08B8806194C41C0C97A1DF0AD2E4DC0322E4C07194C41C01DC02AF9AD2E4DC071D00F08194C41C0CD053802AE2E4DC03744D208194C41C0204B450BAE2E4DC075E69509194C41C0B7CA5214AE2E4DC0F8C29709194C41C00BF3201EAE2E4DC0DB8C5B0A194C41C0A5722E27AE2E4DC05C695D0A194C41C0FAB73B30AE2E4DC0930B210B194C41C090374939AE2E4DC010E8220B194C41C0E67C5642AE2E4DC0468AE60B194C41C07DFC634BAE2E4DC0C266E80B194C41C0167C7154AE2E4DC03A43EA0B194C41C06DC17E5DAE2E4DC06AE5AD0C194C41C004418C66AE2E4DC0E2C1AF0C194C41C0D7355970AE2E4DC0B4C5B10C194C41C070B56679AE2E4DC028A2B30C194C41C009357482AE2E4DC09C7EB50C194C41C09EB4818BAE2E4DC00D5BB70C194C41C039348F94AE2E4DC07E37B90C194C41C010EE9C9DAE2E4DC0324EF90B194C41C0AB6DAAA6AE2E4DC0A12AFB0B194C41C040EDB7AFAE2E4DC00E07FD0B194C41C0198A86B9AE2E4DC065453D0B194C41C0B10994C2AE2E4DC0CE213F0B194C41C089C3A1CBAE2E4DC07C387F0A194C41C02243AFD4AE2E4DC0E514810A194C41C0F7FCBCDDAE2E4DC0902BC109194C41C0CFB6CAE6AE2E4DC03D420109194C41C06536D8EFAE2E4DC09F1E0309194C41C0E0EFE5F8AE2E4DC0BF634408194C41C0B8A9F301AF2E4DC0667A8407194C41C08D63010BAF2E4DC00D91C406194C41C0621D0F14AF2E4DC0B1A70406194C41C037D71C1DAF2E4DC055BE4405194C41C04806EA26AF2E4DC04FFC8404194C41C0E04A382FAF2E4DC095EBC403194C41C0D2B30539AF2E4DC04F924402194C41C06AF85341AF2E4DC091818401194C41C07A27214BAF2E4DC08ABFC400194C41C0891B2F54AF2E4DC06B1043FF184C41C002D53C5DAF2E4DC07E5584FE184C41C011C94A66AF2E4DC05DA602FD184C41C0E082586FAF2E4DC0F5BC42FC184C41C063B8A277AF2E4DC098E5C0FA184C41C015ACB080AF2E4DC0EB6440F9184C41C022A0BE89AF2E4DC0C5B5BEF7184C41C0F359CC92AF2E4DC058CCFEF6184C41C0A54DDA9BAF2E4DC0A94B7EF5184C41C0AE41E8A4AF2E4DC07E9CFCF3184C41C0B935F6ADAF2E4DC052ED7AF2184C41C0C22904B7AF2E4DC0253EF9F0184C41C0AA5712C0AF2E4DC0BAF7B6EE184C41C0B1685FC8AF2E4DC0E62035ED184C41C05F5C6DD1AF2E4DC02EA0B4EB184C41C066507BDAAF2E4DC0FEF032EA184C41C0A67E89E3AF2E4DC0127CEFE7184C41C0C5B3D3EBAF2E4DC01ED36EE6184C41C004E2E1F4AF2E4DC02F5E2BE4184C41C0AFD5EFFDAF2E4DC070DDAAE2184C41C0EB03FE06B02E4DC07F6867E0184C41C0EBBC4C0FB02E4DC035CC23DE184C41C092B05A18B02E4DC0734BA3DC184C41C0CCDE6821B02E4DC07FD65FDA184C41C0AC29B629B02E4DC05F681DD8184C41C0E557C432B02E4DC067F3D9D5184C41C036C70E3BB02E4DC0AE8497D3184C41C07FF61C44B02E4DC0498450D1184C41C048232B4DB02E4DC032C911CF184C41C08E6F7855B02E4DC027A1CACC184C41C0C19D865EB02E4DC0272C87CA184C41C05E56D566B02E4DC04CBE44C8184C41C09049246FB02E4DC03B5C3FC5184C41C062773278B02E4DC0B215FDC2184C41C042797B80B02E4DC02C78B9C0184C41C04EE18989B02E4DC0E86BB5BD184C41C01FD4D891B02E4DC04C38B1BA184C41C04B1F269AB02E4DC0A69B6DB8184C41C0538734A3B02E4DC05B8F69B5184C41C0F4F67EABB02E4DC01DF225B3184C41C0BFE9CDB3B02E4DC07CBE21B0184C41C0C46E1BBCB02E4DC08F8A1DAD184C41C0991866C4B02E4DC0932718AA184C41C09C8074CDB02E4DC0441B14A7184C41C09D05C2D5B02E4DC053E70FA4184C41C0BBF810DEB02E4DC033850AA1184C41C07FEB5FE6B02E4DC08D51069E184C41C08927A9EEB02E4DC03EEE009B184C41C04A1AF8F6B02E4DC095BAFC97184C41C08ADA45FFB02E4DC07C353394184C41C0E9829007B12E4DC05C8C3291184C41C04E09DE0FB12E4DC07D9E298E184C41C006C16D17B12E4DC0C37D638A184C41C009FDB61FB12E4DC06E1A5E87184C41C0F6290628B12E4DC005219883184C41C0EAAE5330B12E4DC008ED9380184C41C0D5DBA238B12E4DC09CF3CD7C184C41C0CDDC2C40B12E4DC039A30679184C41C083CF7B48B12E4DC0836F0276184C41C0A58EC950B12E4DC0C9753C72184C41C004FD5458B12E4DC02454766E184C41C07EBCA260B12E4DC0F12BAF6A184C41C014BD2C68B12E4DC0FE09E966184C41C0F4E97B70B12E4DC08C102363184C41C088EA0578B12E4DC098EE5C5F184C41C068175580B12E4DC023F5965B184C41C05118DF87B12E4DC0B3A4CF57184C41C030626D8FB12E4DC09F830954184C41C04DCABC97B12E4DC001397E4F184C41C0DACA469FB12E4DC00917B84B184C41C0A213D5A6B12E4DC05D81F547184C41C0CA4F5FAEB12E4DC0C4DF6843184C41C09F7CAEB6B12E4DC049E6A23F184C41C056B738BEB12E4DC093FE1A3B184C41C02B01C7C5B12E4DC077DD5437184C41C0E03B51CDB12E4DC0C1F5CC32184C41C0E2BFDFD4B12E4DC0EA0E452E184C41C063C069DCB12E4DC0EAEC7E2A184C41C026B2F9E3B12E4DC05C06F725184C41C0D909C3EAB12E4DC004F76E21184C41C09BFB52F2B12E4DC07610E71C184C41C04736DDF9B12E4DC0B8285F18184C41C0F2706701B22E4DC0FA40D713184C41C00B803608B22E4DC051044E0F184C41C0B2BAC00FB22E4DC0931CC60A184C41C0B53F4F17B22E4DC046AA3A06184C41C023051A1EB22E4DC0389BB201184C41C0C43FA425B22E4DC074B32AFD174C41C05D3F6F2CB22E4DC0A7DEE0F7174C41C04AC3FD33B22E4DC0C4F758F3174C41C0B088C83AB22E4DC0AFE8D0EE174C41C094D19741B22E4DC0C11487E9174C41C02E0C2249B22E4DC0FC2CFFE4174C41C0F99DEB4FB22E4DC0E057B5DF174C41C05A63B656B22E4DC0C6482DDB174C41C037AC855DB22E4DC0D674E3D5174C41C094715064B22E4DC0BC655BD1174C41C057031A6BB22E4DC09C9011CC174C41C08302E571B22E4DC041EAC8C6174C41C048C9AF78B22E4DC03E213CC2174C41C01C127F7FB22E4DC0494DF2BC174C41C0DAA34886B22E4DC02878A8B7174C41C0CB2D548CB22E4DC079AA5FB2174C41C085BF1D93B22E4DC056D515AD174C41C004BFE899B22E4DC07D00CCA7174C41C0D007B8A0B22E4DC0852C82A2174C41C05024C2A6B22E4DC00F30389D174C41C0CA238DADB22E4DC0335BEE97174C41C00BAE98B3B22E4DC0065FA492174C41C05B04A3B9B22E4DC052CB998C174C41C0CE036EC0B22E4DC072F64F87174C41C0552178C6B22E4DC08E6E0282174C41C0CD3D82CCB22E4DC01572B87C174C41C068774DD3B22E4DC07ED7AC76174C41C0DB9357D9B22E4DC003DB6271174C41C03F5863DFB22E4DC01A19576B174C41C056746DE5B22E4DC0174B0E66174C41C0F1CA77EBB22E4DC0E4880260174C41C0245583F1B22E4DC0B08CB85A174C41C0BBAB8DF7B22E4DC07CCAAC54174C41C0F152D8FCB22E4DC0AEA6624F174C41C02BA9E202B32E4DC0F1125849174C41C0936EEE08B32E4DC096C54843174C41C024C5F80EB32E4DC05F033D3D174C41C005233F14B32E4DC0AEDEF237174C41C0E1C24D1AB32E4DC0561DE731174C41C0925A941FB32E4DC06761DC2B174C41C01BB19E25B32E4DC0299FD025174C41C06F92E92AB32E4DC0A0B5C41F174C41C0C6733430B32E4DC015CCB819174C41C06C0B7B35B32E4DC02510AE13174C41C005198B3BB32E4DC0144FA20D174C41C04143D040B32E4DC05B649607174C41C033241B46B32E4DC048A98B01174C41C08105664BB32E4DC0BDBF7FFB164C41C0B6D8AC50B32E4DC02A84AEF4164C41C0FEB9F755B32E4DC09C9AA2EE164C41C0EA9A425BB32E4DC08ADF97E8164C41C0AFBDC95FB32E4DC0CACD8BE2164C41C01ED91465B32E4DC0841EBEDB164C41C006BA5F6AB32E4DC06F63B3D5164C41C0026FE56EB32E4DC06451A7CF164C41C06C8A3074B32E4DC01CA2D9C8164C41C01FF6BB78B32E4DC0B7BFCEC2164C41C04FE6417DB32E4DC0885CFDBB164C41C08AC78C82B32E4DC0F872F1B5164C41C0A8B61287B32E4DC0349B23AF164C41C055229E8BB32E4DC0D0B818A9164C41C06F112490B32E4DC009E14AA2164C41C043B7AF94B32E4DC0EA387E9B164C41C0274FF699B32E4DC0774E7295164C41C05C12C19DB32E4DC04450A48E164C41C0170147A2B32E4DC0F8A6D787164C41C0F15DCEA6B32E4DC07ECF0981164C41C0295C58ABB32E4DC051BEFD7A164C41C0B4B9DFAFB32E4DC0E3892D74164C41C0E57CAAB3B32E4DC0B18B5F6D164C41C0F26B30B8B32E4DC0E7B39166164C41C0889CFCBBB32E4DC07BE4C45F164C41C0928B82C0B32E4DC0B30CF758164C41C0120549C4B32E4DC0173C2A52164C41C0EB7E0FC8B32E4DC0033D5C4B164C41C0AA249BCCB32E4DC0DE948F44164C41C0829E61D0B32E4DC0C995C13D164C41C0FD1728D4B32E4DC02CC5F436164C41C02FDCF2D7B32E4DC08E3B2330164C41C00456B9DBB32E4DC0763C5529164C41C07BCF7FDFB32E4DC0D96B8822164C41C0494946E3B32E4DC0C26CBA1B164C41C0B6874DE6B32E4DC022AF2B14164C41C0D54A18EAB32E4DC0EAB05D0D164C41C047C4DEEDB32E4DC04EE09006164C41C0E3C8E5F0B32E4DC0EAB9C2FF154C41C07B7CACF4B32E4DC0932334F8154C41C02882B3F7B32E4DC0C47162F1154C41C0EFFB79FBB32E4DC0AB7294EA154C41C08ECC7FFEB32E4DC0BCB405E3154C41C027D18601B42E4DC0598E37DC154C41C064D58D04B42E4DC06D966AD5154C41C05CA69307B42E4DC006AADACD154C41C096AA9A0AB42E4DC01BB20DC7154C41C052E9A10DB42E4DC0FDC57DBF154C41C0C57FA710B42E4DC0C8CDB0B8154C41C08EBFAE13B42E4DC03C561DB1154C41C0B5C2B516B42E4DC0BEE953AA154C41C08B1FFC18B42E4DC09D4AC0A2154C41C0BF23031CB42E4DC0B052F39B154C41C0817F491EB42E4DC0FB3E6394154C41C0B4835021B42E4DC01047968D154C41C026969223B42E4DC07B320686154C41C0BA669826B42E4DC08A74777E154C41C018F6DF28B42E4DC0D926A977154C41C07D51262BB42E4DC09D411A70154C41C04BAE6C2DB42E4DC07DA28668154C41C03A86AE2FB42E4DC01682B961154C41C07A79B12FB42E4DC0A6D4E457154C41C02002CB96BE2E4DC0F24E3183054C41C0BCE48287CE2E4DC0FB0B8948ED4B41C072F9D294D52E4DC0621DDB8BE24B41C027FB85AED52E4DC001407158E24B41C09E1B99DCD52E4DC0BE56A42FE24B41C09C63270CD62E4DC00B46DB09E24B41C062426630D62E4DC0D6452CF0E14B41C0D4DC9979D62E4DC042527BD3E14B41C023FE79B4D62E4DC0AFE9DDBFE14B41C0E03BD7F3D62E4DC045BB93B4E14B41C0B0949B4AD72E4DC09FCC14ADE14B41C005DE5FA7D72E4DC02066F6B3E14B41C0C0064EF7D72E4DC0375832C9E14B41C075F3B442D82E4DC0F4C6C6E9E14B41C0A34E2D9AD82E4DC08379DC08E24B41C0C981ED50DC2E4DC0E89B50A4E34B41C0FF69AAAADC2E4DC03261E4C1E34B41C0FEEE6604DD2E4DC0CB7723D7E34B41C092024D48DD2E4DC034AE93C9E34B41C09BAA7188DD2E4DC00616B9B6E34B41C0464170D2DD2E4DC050E65E86E34B41C019318000DE2E4DC0E0EAC759E34B41C0DF130127DE2E4DC025FE8938E34B41C0E4E6F345DE2E4DC015952124E34B41C08D7BB19FDE2E4DC04706703FE34B41C03ED1ED67DF2E4DC0B73E1917E24B41C0FB50AC89E52E4DC0268076D2E44B41C0D5D754DDE42E4DC02A3991FBE54B41C0389CFC58E52E4DC053D79C30E64B41C0CF69AC2EE52E4DC0AF76176DE64B41C09E6C831CE52E4DC0B6A6B79CE64B41C0C4196E16E52E4DC081EA4AC3E64B41C07BF49E12E52E4DC0975299E7E64B41C0761B1711E52E4DC0D5D3D805E74B41C081525319E52E4DC0BA4DB42EE74B41C062A8A027E52E4DC05C99B74DE74B41C004DAB239E52E4DC04CD63C6BE74B41C05600DB5AE52E4DC02D94C188E74B41C075425584E52E4DC064A3389DE74B41C01F981FBFE52E4DC0869A0CC0E74B41C01E08ABFAE52E4DC08FAC23E2E74B41C0AB97A992F22E4DC0A0F93D45ED4B41C06AE32516F62E4DC016A2B1C7EE4B41C06D63875BF62E4DC007D96EDEEE4B41C00C96659CF62E4DC06B905DEEEE4B41C06E6BA2F4F62E4DC0C74B6FEEEE4B41C0F8488735F72E4DC05F90ADE7EE4B41C0F87D6F79F72E4DC0B6B5DAD7EE4B41C019FE53B7F72E4DC0088FD8B2EE4B41C0B0AB2EE9F72E4DC0DDF1FC83EE4B41C0B069DE05F82E4DC0D8E44267EE4B41C025B8B634F82E4DC04B2DF920EE4B41C067202683F82E4DC0D0A73436EE4B41C00765D21EF92E4DC073974944ED4B41C00938F14BFF2E4DC01351F3C9EF4B41C09DECECA7FE2E4DC051FD02EDF04B41C09171C0E5FE2E4DC0FFBDC506F14B41C0C72C13B0FE2E4DC041C90966F14B41C0678574A5FE2E4DC047BD839FF14B41C0FC8E27A6FE2E4DC0743CE1C9F14B41C0FF7D68AEFE2E4DC03EA87FF6F14B41C0D7EE70BDFE2E4DC05EB5A724F24B41C061BB39CAFE2E4DC002ADAA43F24B41C0263860E8FE2E4DC0524E255BF24B41C0034336FEFE2E4DC0A40AED7AF24B41C0C71C6925FF2E4DC0179F2D96F24B41C0B3F5C870FF2E4DC029CFB8CFF24B41C0463DA2B1FF2E4DC0A558F0E1F24B41C011C2E615002F4DC0B7F96F15F34B41C04C815A9B002F4DC05B3F9053F34B41C08E7A222F012F4DC00D9DE48AF34B41C0ECA896DD3B2F4DC0910A647F0C4C41C06CF884303C2F4DC0229B3DA20C4C41C00E6D5D713C2F4DC0BA633BB80C4C41C01D6E22A33C2F4DC006AA3FD40C4C41C0373C64D63C2F4DC02FDEB4E80C4C41C07142E8083D2F4DC0A76040060D4C41C09ADA4E263D2F4DC03F83FC1F0D4C41C08DA04A5A3D2F4DC0F5B67B560D4C41C027A1F07F3D2F4DC06F993E8F0D4C41C0E1C1788A3D2F4DC0D3C008B20D4C41C0FB30338E3D2F4DC0FC4BD6D40D4C41C0162533943D2F4DC0F6BDA0F70D4C41C05568EB973D2F4DC07AA5FD210E4C41C0DA48C6883D2F4DC05012A2510E4C41C08C8854743D2F4DC004AEAA920E4C41C0B0E818563D2F4DC0A797EFD20E4C41C09D94DB3A3D2F4DC0533A861B0F4C41C027CDB62B3D2F4DC017CAEE4E0F4C41C08FB07C74172F4DC05F8FD1727A4C41C0C1684C62172F4DC046EB69BB7A4C41C047F7984B172F4DC068D670FC7A4C41C0FCCEE934172F4DC01543A4337B4C41C09738EB15172F4DC0AB95B25B7B4C41C0DA1762EC162F4DC01BF19C907B4C41C01581D5BF162F4DC0BB1D92AC7B4C41C0DD53D497162F4DC0C0A677C27B4C41C0CCECCD6C162F4DC00E8A1FD97B4C41C0531B0E47162F4DC06BD7BDE97B4C41C08F5AD3F7152F4DC02EC18FF97B4C41C085391CD2152F4DC08ACB0BFB7B4C41C0EA04F88E152F4DC00C9242FD7B4C41C07B005F50152F4DC07C3430FA7B4C41C0D241780C152F4DC0B8EB53F37B4C41C0ED9BB0AF142F4DC02A7441F37B4C41C05059B934142F4DC0F94BD4EA7B4C41C0B6CC7EB4132F4DC03B681EDD7B4C41C02F5EEC85EB2E4DC07BBCC88F784C41C0BA995019EB2E4DC0AF26DE85784C41C064DEEDABEA2E4DC079670082784C41C08BCB8263EA2E4DC07291A67C784C41C0D13D0712EA2E4DC099941F81784C41C0817489C0E92E4DC0DC21298D784C41C06D1F5677E92E4DC092B7C3A0784C41C0B85A313AE92E4DC0E717FDC1784C41C08F33B6EEE82E4DC0CDCCFEE6784C41C0523226BFE82E4DC099C69010794C41C0C6D89F98E82E4DC0EDD91234794C41C0F460C363E82E4DC05ECCFA68794C41C0DF4B353DE82E4DC00EFE81AB794C41C0F44EB61CE82E4DC04E0C7BE6794C41C05F9458F7E72E4DC0EBB49D417B4C41C023DBC4C1E72E4DC0E556294C7B4C41C02248F5FEE62E4DC094E91708814C41C0534FF5C0E52E4DC0F7A4AB908C4C41C0F6D2EEABDC2E4DC0312DD58E8C4C41C09EBF0C27DE2E4DC0D2A5CB04814C41C039D9BE09DF2E4DC09E9026977A4C41C067D1B7D8DE2E4DC0202F93927A4C41C0C204F5EDDE2E4DC0E927B82B7A4C41C0477459F3DE2E4DC0961875CF794C41C0B78D2FF1DE2E4DC0E975F376794C41C09AF240EEDE2E4DC089FB502B794C41C05DD010E9DE2E4DC03B5143EA784C41C0868037CDDE2E4DC02E9CA7A4784C41C05D745EAEDE2E4DC090059060784C41C072921F78DE2E4DC015BDBD21784C41C00B497D24DE2E4DC0E54780D1774C41C0A9F19BDADD2E4DC069C81FAA774C41C05F530A9FDD2E4DC0E05CD08B774C41C054B04D45DD2E4DC0370EC672774C41C045A127FFDC2E4DC0EA406A6A774C41C00530E478DC2E4DC0AB81315E774C41C0F4E8A3F8DB2E4DC06061C655774C41C0FADE6672BE2E4DC05FB9AE11754C41C0DEDA124E922E4DC09E94747B714C41C046791E29922E4DC07F76E376714C41C063DED3F5912E4DC00002CD70714C41C0BB9C25D3912E4DC0C197E060714C41C096F73BB1912E4DC01F856849714C41C00FAE777C912E4DC0607F7B1A714C41C0C8602168912E4DC09FB2F5FC704C41C0D1341956912E4DC084CA88CC704C41C0CE55705E912E4DC0745AAEA0704C41C04C491669912E4DC087F2A35F704C41C04B714B81912E4DC0B0E52C26704C41C05CE6859C912E4DC0B79196DD6F4C41C03F4CAAA8912E4DC0559AF7B06F4C41C0025D72A8A42E4DC08AE9B2283A4C41C0FEF1B9AAA42E4DC01811E1213A4C41C0905200ADA42E4DC012FE501A3A4C41C0C5B246AFA42E4DC08219C2123A4C41C0A6C988B1A42E4DC01034330B3A4C41C08C5DD0B3A42E4DC00AE764043A4C41C0C1BD16B6A42E4DC07B02D6FC394C41C0295F99B7A42E4DC015C745F5394C41C0EB84DFB9A42E4DC03DA878EE394C41C0642762BBA42E4DC06CE1E4E6394C41C08486A8BDA42E4DC0498859DF394C41C04D722FBFA42E4DC058C2C5D7394C41C07CD275C1A42E4DC0C7DD36D0394C41C07239F8C2A42E4DC0186868C9394C41C07BDA7AC4A42E4DC02B5BD9C1394C41C030C501C6A42E4DC0A72049BA394C41C08AAF88C7A42E4DC09C14BAB2394C41C0CCE209C9A42E4DC063072BAB394C41C091CE90CAA42E4DC0744197A3394C41C0866E13CCA42E4DC0F2BF0B9C394C41C0612DD5CCA42E4DC058D17794394C41C04ADD5BCEA42E4DC0048BAA8D394C41C0DA081FCFA42E4DC023281A86394C41C031F3A5D0A42E4DC0171C8B7E394C41C0F8B067D1A42E4DC0E9B8FA76394C41C0FB51EAD2A42E4DC0FAAB6B6F394C41C0B958B0D3A42E4DC02B78DC67394C41C0598573D4A42E4DC0DB894860394C41C0B14135D5A42E4DC093E0BC58394C41C08B00F7D5A42E4DC0F9F12851394C41C0BC2BBAD6A42E4DC090BD9949394C41C0D53280D7A42E4DC0475B0942394C41C0035E43D8A42E4DC0DD267A3A394C41C0FAA545D8A42E4DC0349CE932394C41C0636307D9A42E4DC080675A2B394C41C0FFAA09D9A42E4DC04F0BCB23394C41C0EE20D1D9A42E4DC0E31D371C394C41C08868D3D9A42E4DC0B4C1A714394C41C04B2695DAA42E4DC0875E170D394C41C0E66D97DAA42E4DC058028805394C41C0DBB599DAA42E4DC0AE77F7FD384C41C076FD9BDAA42E4DC07E1B68F6384C41C010459EDAA42E4DC04DBFD8EE384C41C0048DA0DAA42E4DC0A63448E7384C41C09ED4A2DAA42E4DC076D8B8DF384C41C0D8A7E5D9A42E4DC0E69A24D8384C41C072EFE7D9A42E4DC0B83E95D0384C41C06837EAD9A42E4DC00DB404C9384C41C01B5227D9A42E4DC0342F75C1384C41C044246AD8A42E4DC0117DE4B9384C41C0DF6B6CD8A42E4DC0E12055B2384C41C0E6CFADD7A42E4DC0EB9CC5AA384C41C0BB58ECD6A42E4DC0E4E934A3384C41C0D6BD2DD6A42E4DC082DAA19B384C41C0FF8F70D5A42E4DC05F281194384C41C0CD61B3D4A42E4DC0B3A4818C384C41C031C6F4D3A42E4DC044F2F084384C41C03E1433D3A42E4DC06D33237E384C41C0A47874D2A42E4DC0FC809276384C41C0A6D4F7D0A42E4DC0D6D5026F384C41C05EEF34D0A42E4DC0FD507367384C41C0F8DDB6CEA42E4DC01177E25F384C41C08667F5CDA42E4DC01A674F58384C41C0235677CCA42E4DC02D8DBE50384C41C06144F9CAA42E4DC0BDE12E49384C41C0ACE976C9A42E4DC0F0069E41384C41C07EBBB9C8A42E4DC044830E3A384C41C06C6037C7A42E4DC0F1D67E32384C41C07D55F5C4A42E4DC05E9AAF2B384C41C0BF4377C3A42E4DC0EDEE1F24384C41C05E32F9C1A42E4DC001158F1C384C41C04ED776C0A42E4DC0AC68FF14384C41C0E20735BEA42E4DC0F7DA6A0D384C41C0B8BBB6BCA42E4DC03AF59C06384C41C03CEB74BAA42E4DC0F2F20BFF374C41C082D9F6B8A42E4DC082477CF7374C41C00809B5B6A42E4DC03645EBEF374C41C0C5FD72B4A42E4DC01D371DE9374C41C086BF2FB2A42E4DC087348CE1374C41C00438F2AFA42E4DC09A61FCD9374C41C03367B0ADA42E4DC0C88D6CD2374C41C05F5D6EABA42E4DC0C9C599CB374C41C0231F2BA9A42E4DC035C308C4374C41C0A597EDA6A42E4DC046F078BC374C41C0C18CABA4A42E4DC0B3B3A9B5374C41C065D8A8A1A42E4DC01AB819AE374C41C083CD669FA42E4DC0877B4AA7374C41C02819649CA42E4DC0EC7FBA9F374C41C0ED0D229AA42E4DC0D471EC98374C41C051A42397A42E4DC039BD5791374C41C03F222294A42E4DC00D138D8A374C41C003261B91A42E4DC0AD5CF882374C41C07864DD8EA42E4DC0FA20297C374C41C025B0DA8BA42E4DC060259974374C41C0BCC1D788A42E4DC004C1C96D374C41C0A2971585A42E4DC0EE9D3966374C41C002171482A42E4DC0DC396A5F374C41C0EDDE0C7FA42E4DC017039C58374C41C034B54A7BA42E4DC087B10A51374C41C086C74778A42E4DC038F0384A374C41C023D94475A42E4DC0DB8B6943374C41C012AF8271A42E4DC0C368D93B374C41C0EB4AC06DA42E4DC0EADC0935374C41C0F8C9BE6AA42E4DC052A73B2E374C41C0D365FC66A42E4DC0771B6C27374C41C0AF013A63A42E4DC09A8F9C20374C41C019E6715FA42E4DC00D31CE19374C41C069BCAF5BA42E4DC07BDF3C12374C41C00159ED57A42E4DC0ACF66A0B374C41C091AB2654A42E4DC0F0699B04374C41C073476450A42E4DC012DECBFD364C41C0386DE24BA42E4DC03359FDF6364C41C01D092048A42E4DC057CD2DF0364C41C0CB779843A42E4DC049475FE9364C41C0B413D63FA42E4DC06DBB8FE2364C41C0F4474E3BA42E4DC013FB82DC364C41C0DFE38B37A42E4DC0376FB3D5364C41C0B4C00533A42E4DC0FCBAE3CE364C41C0CD79822EA42E4DC060AA11C8364C41C0A456FC29A42E4DC022F641C1364C41C09AD47825A42E4DC0340834BB364C41C01AB1F220A42E4DC06E8265B4364C41C083696F1CA42E4DC0C7CE95AD364C41C04155ED17A42E4DC020E187A7364C41C000C46513A42E4DC0115BB9A0364C41C0BFAFE30EA42E4DC0676DAB9A364C41C0BDA89C09A42E4DC0D9BFDC93364C41C082941A05A42E4DC032D2CE8D364C41C0A0039300A42E4DC0A41DFF86364C41C031C24BFBA32E4DC0CC35F280364C41C0A3BC04F6A32E4DC053CE1E7A364C41C06BA882F1A32E4DC0AAE01074364C41C05B673BECA32E4DC055CA026E364C41C0B5A9F8E6A32E4DC0A61D3467364C41C0A868B1E1A32E4DC04F072661364C41C0609D29DDA32E4DC07718185B364C41C04DA5E6D7A32E4DC07D310B55364C41C082EEDFD1A32E4DC0A6F3FC4E364C41C07CAD98CCA32E4DC051DDEE48364C41C08CA651C7A32E4DC0B92F2042364C41C09B660AC2A32E4DC0F48D0E3C364C41C0EB6EC7BCA32E4DC07E780036364C41C0B67DC0B6A32E4DC05E00B430364C41C0B53C79B1A32E4DC003EAA52A364C41C09B8572ABA32E4DC0A3DA9824364C41C0A0442BA6A32E4DC047C48A1E364C41C01D2023A0A32E4DC022867C18364C41C062691C9AA32E4DC046486E12364C41C0EE36D994A32E4DC0FB26230D364C41C0E536CE8EA32E4DC03EE81407364C41C02290CB88A32E4DC08DE5C401364C41C0A76BC382A32E4DC067A7B6FB354C41C0F5B4BC7CA32E4DC08869A8F5354C41C0D1C3B576A32E4DC05FF15BF0354C41C0E764AD70A32E4DC0EC780FEB354C41C0DFADA66AA32E4DC0866902E5354C41C0E68FDA63A32E4DC0AFC8B5DF354C41C0C89ED35DA32E4DC0855069DA354C41C07531D157A32E4DC087135BD4354C41C081130551A32E4DC0AD720ECF354C41C09FB4FC4AA32E4DC035FAC1C9354C41C02BC3F544A32E4DC081B076C4354C41C091EE2D3EA32E4DC089102ABF354C41C0071B6637A32E4DC023E5D9B9354C41C0F4295F31A32E4DC0F56C8DB4354C41C05D55972AA32E4DC0FACC40AF354C41C08EEED023A32E4DC0492DF4A9354C41C0A9D0041DA32E4DC06C8CA7A4354C41C016FC3C16A32E4DC06EEC5A9F354C41C08727750FA32E4DC0704C0E9A354C41C04886AE08A32E4DC072728395354C41C06868E201A32E4DC091D13690354C41C0DC931AFBA22E4DC09031EA8A354C41C0DB8452F4A22E4DC045575F86354C41C0BF1D8CEDA22E4DC007E61381354C41C06EC5BFE6A22E4DC0D90A897C354C41C00E4138DFA22E4DC094DAFC77354C41C0326C70D8A22E4DC00869B172354C41C05315A4D1A22E4DC0F3D3216E354C41C09E901CCAA22E4DC021D29669354C41C020BC54C3A22E4DC01D324A64354C41C01AEEC8BBA22E4DC0672FBF5F354C41C06A6941B4A22E4DC0952D345B354C41C0795A79ADA22E4DC04253A956354C41C07A8CEDA5A22E4DC08C501E52354C41C07BBE619EA22E4DC0D34D934D354C41C090AF9997A22E4DC07F730849354C41C0E72A1290A22E4DC0A7717D44354C41C0C76B8A88A22E4DC08535B440354C41C01A31FD80A22E4DC013A7253C354C41C066AB7579A22E4DC0A4309E37354C41C0F6A2E971A22E4DC09CF3D433354C41C071D65D6AA22E4DC0F936452F354C41C05817D662A22E4DC0D3FA7B2B354C41C0BB924E5BA22E4DC0F6F8F026354C41C0D1A60153A22E4DC01B942723354C41C0E4D8754BA22E4DC058919C1E354C41C0D119EE43A22E4DC03055D31A354C41C01A5B663CA22E4DC089EA0817354C41C0376F1934A22E4DC0AD853F13354C41C0D5668D2CA22E4DC0A048760F354C41C06CB54024A22E4DC0081EEB0A354C41C060F6B81CA22E4DC0D8E12107354C41C0820A6C14A22E4DC0F77C5803354C41C05911E40CA22E4DC005D84F00354C41C044939804A22E4DC06B7386FC344C41C03DD410FDA12E4DC03737BDF8344C41C062E8C3F4A12E4DC052D2F3F4344C41C07EC376ECA12E4DC03E79E7F1344C41C0BF8E2FE4A12E4DC083151EEE344C41C0A618A2DCA12E4DC01FD854EA344C41C0776056D4A12E4DC0BD0A4CE7344C41C0F8BD0DCCA12E4DC0B5A682E3344C41C07005C2C3A12E4DC0CA077BE0344C41C07FDF74BBA12E4DC01A3A72DD344C41C0B2F327B3A12E4DC02DD5A8D9344C41C08184E0AAA12E4DC02137A1D6344C41C0925E93A2A12E4DC06E6998D3344C41C011A6479AA12E4DC07DCA90D0344C41C0CD7FFA91A12E4DC0412B89CD344C41C0FB10B389A12E4DC0B85E80CA344C41C0B8EA6581A12E4DC079BF78C7344C41C075C41879A12E4DC0392071C4344C41C0D5280C70A12E4DC0F82A68C1344C41C0DC35C067A12E4DC0B95122BF344C41C04A59775FA12E4DC0DE8419BC344C41C054BD6A56A12E4DC014BE11B9344C41C05C215E4DA12E4DC049F709B6344C41C015FCB7099C2E4DC0E4582D6B334C41C0C960AB009C2E4DC04F912568334C41C0F7005EF89B2E4DC08C88DE65334C41C0172B51EF9B2E4DC0AB869863334C41C059CC03E79B2E4DC07CF24D61334C41C067F5F6DD9B2E4DC0047C0B5F334C41C0C44DAFD59B2E4DC001E9C05C334C41C04178A2CC9B2E4DC0A1B8795A334C41C01B1855C49B2E4DC052DE3358334C41C09A4248BB9B2E4DC0F1ADEC55334C41C0C16C3BB29B2E4DC006ACA653334C41C0F70CEEA99B2E4DC038A35F51334C41C0E1FCE0A09B2E4DC08838DA4F334C41C00927D4979B2E4DC09B36944D334C41C00935888F9B2E4DC0182E4D4B334C41C09A247B869B2E4DC0E0F1C849334C41C01F4F6E7D9B2E4DC073C18147334C41C0B13E61749B2E4DC03885FD45334C41C04128186C9B2E4DC0477DB643334C41C02F180B639B2E4DC08D123142334C41C06042FE599B2E4DC09710EB3F334C41C05032F1509B2E4DC0DAA5653E334C41C0BA05A5489B2E4DC00563E03C334C41C050F5973F9B2E4DC0C1265C3B334C41C044E58A369B2E4DC002BCD639334C41C0B1A17C2D9B2E4DC0BAB99037334C41C0A5916F249B2E4DC0F84E0B36334C41C09881621B9B2E4DC036E48534334C41C0347155129B2E4DC0EBA70133334C41C0296148099B2E4DC0243D7C31334C41C0504300019B2E4DC0DDC0B830334C41C04733F3F79A2E4DC01856332F334C41C0E622E6EE9A2E4DC0C519AF2D334C41C0DD12D9E59A2E4DC0FCAE292C334C41C038C8CBDC9A2E4DC0E609662B334C41C034B8BED39A2E4DC01A9FE029334C41C0D2A7B1CA9A2E4DC0C5625C28334C41C0305DA4C19A2E4DC0ABBD9827334C41C02D4D97B89A2E4DC0D9521326334C41C089028AAF9A2E4DC0BEAD4F25334C41C08EB77CA69A2E4DC01A378D24334C41C09EA86F9D9A2E4DC0DA400423334C41C0FC5D62949A2E4DC0BB9B4022334C41C04A12558B9A2E4DC005828021334C41C0ACC747829A2E4DC0E1DCBC20334C41C0B17C3A799A2E4DC03666FA1F334C41C0C56D2D709A2E4DC0F06F711E334C41C0252320679A2E4DC0CCCAAD1D334C41C087D8125E9A2E4DC09F25EA1C334C41C04A5305559A2E4DC03046E81C334C41C03225374B9A2E4DC01C79241C334C41C028D929429A2E4DC0D88D651B334C41C08A8E1C399A2E4DC0AAE8A11A334C41C000450F309A2E4DC00DB8DA19334C41C0C3BF01279A2E4DC095D8D819334C41C02975F41D9A2E4DC063331519334C41C08C2AE7149A2E4DC0318E5118334C41C050A5D90B9A2E4DC0B4AE4F18334C41C0B75ACC029A2E4DC07F098C17334C41C07BD5BEF9992E4DC0002A8A17334C41C08CDAF1EF992E4DC0DF228817334C41C0F18FE4E6992E4DC0A77DC416334C41C0B70AD7DD992E4DC0239EC216334C41C07A85C9D4992E4DC09DBEC016334C41C03E00BCCB992E4DC015DFBE16334C41C0A5B5AEC2992E4DC0D739FB15334C41C06B30A1B9992E4DC04E5AF915334C41C02FAB93B0992E4DC0C47AF715334C41C0F22586A7992E4DC0399BF515334C41C03FBDB79D992E4DC0C093F315334C41C060FDA994992E4DC0E979B316334C41C023789C8B992E4DC0589AB116334C41C0E9F28E82992E4DC0C7BAAF16334C41C0AE6D8179992E4DC033DBAD16334C41C0CFAD7370992E4DC057C16D17334C41C094286667992E4DC0C3E16B17334C41C058A3585E992E4DC02B026A17334C41C07AE34A55992E4DC049E82918334C41C08AE87D4B992E4DC010E12718334C41C0A9287042992E4DC02CC7E718334C41C0CB686239992E4DC047ADA719334C41C08FE35430992E4DC0A9CDA519334C41C09B224727992E4DC02D3F691A334C41C0B862391E992E4DC04525291B334C41C045A42B15992E4DC07351E41B334C41C00B1F1E0C992E4DC0D071E21B334C41C0275F1003992E4DC0E357A21C334C41C0449F02FA982E4DC0F23D621D334C41C063DFF4F0982E4DC00424221E334C41C06D1EE7E7982E4DC07C95E51E334C41C0C74018DE982E4DC0DBEA6520334C41C0E2800AD5982E4DC0E7D02521334C41C011C2FCCB982E4DC0872BE221334C41C02E02EFC2982E4DC08F11A222334C41C08F06E1B9982E4DC0B9482724334C41C00647D3B0982E4DC04600E624334C41C02087C5A7982E4DC04CE6A525334C41C0948CB79E982E4DC005922727334C41C0AFCCA995982E4DC00878E727334C41C07BD29B8C982E4DC046F56729334C41C094128E83982E4DC045DB272A334C41C0D244457B982E4DC0CDAFA92B334C41C0404A3772982E4DC07E5B2B2D334C41C00C502969982E4DC0B8D8AB2E334C41C025901B60982E4DC0B1BE6B2F334C41C092950D57982E4DC0626AED30334C41C0009BFF4D982E4DC010166F32334C41C0C8A0F144982E4DC04593EF33334C41C035A6E33B982E4DC0F13E7135334C41C0A1ABD532982E4DC09BEAF236334C41C067B1C729982E4DC0CB677338334C41C0852C7921982E4DC0163BF539334C41C0A3F76A18982E4DC0FA7D373C334C41C00CFD5C0F982E4DC09D29B93D334C41C075024F06982E4DC042D53A3F334C41C08DCD40FD972E4DC020187D41334C41C0C0FFF7F4972E4DC095ECFE42334C41C02805EAEB972E4DC034988044334C41C07762DAE2972E4DC0C5DAC246334C41C0DC67CCD9972E4DC062864448334C41C06B167FD1972E4DC02BF1864A334C41C024E170C8972E4DC07C62CA4C334C41C086E662BF972E4DC0160E4C4E334C41C04B2714B7972E4DC08E788E50334C41C001F205AE972E4DC0DCE9D152334C41C010BDF7A4972E4DC0B02C1455334C41C091B4AE9C972E4DC0CDC65757334C41C0A27FA093972E4DC09E099A59334C41C005C0518B972E4DC089A2DD5B334C41C0A4894382972E4DC03D9F245E334C41C078CBF479972E4DC0437E6360334C41C01495E670972E4DC0F37AAA62334C41C098439968972E4DC0ADE5EC64334C41C0430E8B5F972E4DC0F0563067334C41C055984057972E4DC03EC27269334C41C05128324E972E4DC035F9776C334C41C0D0D6E445972E4DC0E963BA6E334C41C07BA1D63C972E4DC026D5FD70334C41C086A78734972E4DC046050274334C41C08F313D2C972E4DC08E704476334C41C088C12E23972E4DC080A74979334C41C00370E11A972E4DC030128C7B334C41C0AB759212972E4DC0C170917E334C41C0FE058409972E4DC035799581334C41C019C33A01972E4DC07BAA9984334C41C06E03ECF8962E4DC05443DD86334C41C072099DF0962E4DC06973E189334C41C0DC7C4FE8962E4DC043D2E68C334C41C0250D41DF962E4DC0B0DAEA8F334C41C0745CF6D6962E4DC0A30BEF92334C41C0DCCFA8CE962E4DC0796AF495334C41C0D7D559C6962E4DC0889AF898334C41C07C9110BE962E4DC0AB85019C334C41C08798C1B5962E4DC04E2A029F334C41C06C9D72AD962E4DC0C5E509A2334C41C01ED624A5962E4DC04B0AD1A5334C41C07926DA9C962E4DC0CCAFD1A8334C41C01E998C94962E4DC08D6BD9AB334C41C005643D8C962E4DC0C58FA0AF334C41C049B3F283962E4DC0AEC0A4B2334C41C00027A57B962E4DC000F1A8B5334C41C00C1F1B74962E4DC0930F6FB9334C41C09D24CC6B962E4DC00E6E74BC334C41C0DAEF7C63962E4DC0C7633AC0334C41C0D8282F5B962E4DC0C95900C4334C41C0365BA553962E4DC019E105C7334C41C06B26564B962E4DC0CFD6CBCA334C41C0A2F10643962E4DC083CC91CE334C41C0A4E97C3B962E4DC011EB57D2334C41C09D222F33962E4DC00EE11DD6334C41C02528E02A962E4DC0813F23D9334C41C023205623962E4DC0085EE9DC334C41C051EB061B962E4DC0B753AFE0334C41C0DEE17C13962E4DC0222C7AE4334C41C09991EE0B962E4DC059BE3CE8334C41C029D9A403962E4DC0E97AC4EC334C41C0F51815FC952E4DC0AA238EF0334C41C0E151C7F3952E4DC0A01954F4334C41C0D6493DEC952E4DC01F381AF8334C41C0578AADE4952E4DC0EA83E1FB334C41C0934723DD952E4DC021686900344C41C0B312D4D4952E4DC0C65D2F04344C41C0EFCF49CD952E4DC0FB41B708344C41C08B7EBBC5952E4DC0935F7D0C344C41C0C23B31BE952E4DC0C6430511344C41C05CEAA2B6952E4DC05D61CB14344C41C08DA718AF952E4DC08E455319344C41C001E888A7952E4DC050911A1D344C41C034A5FE9F952E4DC07F75A221344C41C010197098952E4DC0C9582A26344C41C0F310E690952E4DC03E77F029344C41C0BD835789952E4DC0F3E57B2E344C41C0E840CD81952E4DC01FCA0333344C41C012FE427A952E4DC048AE8B37344C41C01F04B372952E4DC04191133C344C41C0C6A4E96B952E4DC05F9D9B40344C41C0D1AA5964952E4DC058802345344C41C0F467CF5C952E4DC07D64AB49344C41C038080656952E4DC0139F344E344C41C0400E764E952E4DC00B82BC52344C41C05ECBEB46952E4DC02D664457344C41C0E0B41C40952E4DC01671CC5B344C41C0FC719238952E4DC039555460344C41C0166AC731952E4DC0BC269E65344C41C0AC0AFE2A952E4DC0D432266A344C41C0AB106E23952E4DC0C315AE6E344C41C07375A41C952E4DC0FB72FB73344C41C0EE5ED515952E4DC0E37D8378344C41C048E14A0E952E4DC0B627CD7D344C41C010148007952E4DC07C335582344C41C01F0CB500952E4DC0FB049F87344C41C093F5E5F9942E4DC0DE0F278C344C41C0645B1CF3942E4DC0A6E17091344C41C0288E51EC942E4DC06AEDF895344C41C08D8686E5942E4DC06D90419B344C41C059ECBCDE942E4DC032628BA0344C41C00D9BEDD7942E4DC0C832D5A5344C41C059CC22D1942E4DC070F861AA344C41C0B9C457CA942E4DC06E9BAAAF344C41C07F2A8EC3942E4DC02F6DF4B4344C41C02BD9BEBC942E4DC0C33D3EBA344C41C0E346B3B6942E4DC0E73688BF344C41C0A5ACE9AF942E4DC0A708D2C4344C41C09DA41EA9942E4DC01ADA1BCA344C41C0168014A3942E4DC087D365CF344C41C00E78499C942E4DC0FAA4AFD4344C41C0DE533F96942E4DC0EE6FF8D9344C41C0D34B748F942E4DC05D4142DF344C41C07DB96889942E4DC07B3A8CE4344C41C0269B9A82942E4DC00CD197EA344C41C0D1088F7C942E4DC028CAE1EF344C41C03EE48476942E4DC092C32BF5344C41C017167970942E4DC0D00D3BFB344C41C0C57BAF69942E4DC087DF8400354C41C0C4E9A363942E4DC02AAACD05354C41C0718A995D942E4DC04569D90B354C41C0D8658F57942E4DC0AA622311354C41C0BA988351942E4DC07A212F17354C41C01D74794B942E4DC0DD1A791C354C41C020156F45942E4DC07FAB8322354C41C0B782633F942E4DC094A4CD27354C41C05A235939942E4DC0AE63D92D354C41C0FAC34E33942E4DC0C822E533354C41C01315042E942E4DC0D8432F39354C41C0F1FDFD27942E4DC03F8F3E3F354C41C02031F221942E4DC0911F4945354C41C07847A71C942E4DC05506554B354C41C0CC229D16942E4DC0B3FF9E50354C41C021395211942E4DC077E6AA56354C41C013DA470B942E4DC01277B55C354C41C063F0FC05942E4DC0D45DC162354C41C02D23F1FF932E4DC09D1CCD68354C41C080EFABFA932E4DC0F98FDC6E354C41C0290661F5932E4DC04248E774354C41C0741C16F0932E4DC0042FF37A354C41C0394F0AEA932E4DC0C9EDFE80354C41C0D3AEC3E4932E4DC06ED50A87354C41C073C578DF932E4DC0B48D158D354C41C0B6DB2DDA932E4DC074742193354C41C0C05FE4D4932E4DC07E5B2D99354C41C0F4849DCF932E4DC05EDAF99F354C41C0339B52CA932E4DC01BC105A6354C41C071B107C5932E4DC0D9A711AC354C41C0AB8580C0932E4DC0974221B2354C41C0856135BB932E4DC08FC0EDB8354C41C0BE77EAB5932E4DC04DA7F9BE354C41C0CFBA64B1932E4DC0EAB605C5354C41C0A49619AC932E4DC0E134D2CB354C41C0B0D993A7932E4DC07C44DED1354C41C024B548A2932E4DC0EEF0ABD8354C41C07241BD9D932E4DC0DED0B6DE354C41C0E51C7298932E4DC04E7D84E5354C41C0ED5FEC93932E4DC0EA8C90EB354C41C0C9FA648F932E4DC073335DF2354C41C0F7101A8A932E4DC02A1A69F8354C41C0D6CE8F85932E4DC0037A3AFF354C41C0AE690881932E4DC08C200706364C41C05D637E7C932E4DC0402F130C364C41C0D5FDF677932E4DC04204E112364C41C01DBD6C73932E4DC031AAAD19364C41C05492E56E932E4DC07EB9B91F364C41C09A515B6A932E4DC0705F8626364C41C094CF9466932E4DC06E5C542D364C41C0086A0D62932E4DC06D312234364C41C03728835D932E4DC0C862F23A364C41C066FDFB58932E4DC01272FE40364C41C00A323155932E4DC02B6ECC47364C41C0983AAB50932E4DC0FC14994E364C41C08EB8E44C932E4DC0F9116755364C41C0FF095948932E4DC09BB7335C364C41C0F1879244932E4DC098B40163364C41C03D06CC40932E4DC01983CE69364C41C0DA3A013D932E4DC0327F9C70364C41C040D57938932E4DC02F546A77364C41C07252B334932E4DC01BAE3A7E364C41C073D1EC30932E4DC0AC1F0585364C41C0F504222D932E4DC02FA7D68B364C41C0AD79DA27932E4DC02277E894364C41C0DECC0C1C852E4DC0CBF39B515D4C41C05C4D296A842E4DC0B01C4A555F4C41C0E1BA7C9C7D2E4DC0063CF2C75E4C41C04A574317772E4DC05DE691125E4C41C038BB23A06F2E4DC0FDEAE4805C4C41C09C1C49CC652E4DC072934B265A4C41C0EAFEAE0A542E4DC078DF24EE514C41C0B1FA34A6382E4DC0EDA6553F454C41C0E3DD4D1F392E4DC07BE9C0FE434C41C053BA2EE3322E4DC0C71A5E2D414C41C01F580B52322E4DC09C8C001D424C41C0E68D8FDE232E4DC03D56C7113B4C41C089D916F1202E4DC04C1CE3E4394C41C05ABF11C81E2E4DC0D81AF4B3374C41C08EF6F81F1F2E4DC05C74F310344C41C0D562A971202E4DC05DC5AA15304C41C075C69DF91F2E4DC0B74FA7082E4C41C01E9DE7CB1E2E4DC04AC5F17D2B4C41C0CF63A6D81B2E4DC01D605A89294C41C0A47EB5A7182E4DC05415B66F294C41C0123AEF4A162E4DC0C094B8BF284C41C0753A91CB0F2E4DC0CF0E52BE284C41C07A034675042E4DC06FFBC12B274C41C03602986AFD2D4DC0D14BAE71264C41C0B0C12334FA2D4DC066719510274C41C0379104F5EE2D4DC097730632264C41C0E93F31A1EB2D4DC00C7DC8A5264C41C0A920CD18E92D4DC0F03CF4E8274C41C0FCAD2ECFE82D4DC0D3B7ED50294C41C011D4AA3CE32D4DC0379AE7F7264C41C0D4689B62592D4DC08A1703C31E4C41C09818F46E582D4DC0CB3742BE1E4C41C021269028F22C4DC073505D6E2E4C41C097439919F22C4DC08C45BAA5344C41C0B6AF3272092D4DC0283FF3F5304C41C019DFBC07592D4DC006405149244C41C0028D4B86B52D4DC08EC1B6832B4C41C07B4CC1B0BC2D4DC0BB6AC8F92B4C41C06691CEB9BC2D4DC0C2308CFA2B4C41C0BE0DF1A9C82D4DC0C53484A82D4C41C0D9DB02CDCC2D4DC09C185ADB2D4C41C01EEB2C48E42D4DC0CF30E3FC2E4C41C0ED381AF4FB2D4DC0A8C6C1F6304C41C08B80FF79182E4DC06A287B073E4C41C01B300047262E4DC0E5EFC65A444C41C0D01EB98A352E4DC042DCC0514B4C41C066B84B7D3C2E4DC03B414A7D4E4C41C052138FE2592E4DC0D9C345E15B4C41C0E4E34D79742E4DC095D53928684C41C0B731D95D802E4DC0A4D8CB8C6D4C41C0AFEED8A3852E4DC078D609AB6E4C41C016D74A07852E4DC018B9E7F06F4C41C0BC4B1438882E4DC030B9C79E704C41C0C6E91CDE862E4DC08CFC549C744C41C04E381E0E822E4DC0BA2F3ECA834C41C0D5F02CF87F2E4DC045A3D4A68A4C41C08A564F1D7F2E4DC0204435788D4C41C0F33251C48E2E4DC0A2549A798E4C41C0FDEBCBE1922E4DC0DFE353D08F4C41C0284BD89AD72E4DC098527037954C41C0B2CE8EA8EA2E4DC0AFC1FFCA954C41C0833705E5032F4DC0925F15BA934C41C0F4DA88E1052F4DC087F11E90934C41C0BB7668D4132F4DC052DBEFFA944C41C02591804F1B2F4DC0075FCBA4984C41C01401C25F1E2F4DC0F7A591C5994C41C06831C1F84B2F4DC0D0462E26964C41C017D5CF6F842F4DC092177352984C41C010E1901F972F4DC05179C8346F4C41C0D6187DF1A52F4DC0008393164E4C41C0BD688CC6BF2F4DC09EFC8A29194C41C0A14D336BD72F4DC08F45596B014C41C04D17A3F2D82F4DC0D262B3E5FE4B41C0DCE70DA0DB2F4DC0E6638C32FD4B41C0FB386942DC2F4DC06E1D488FFC4B41C0050867D306304DC0F3716EC3E14B41C0F90E306937304DC0A86C3797C14B41C0C3BE021E57304DC00E466E97AC4B41C0920905E094304DC0E4A12CFD854B41C07B7985A121314DC06FF5E8F8384B41C0A4B13FF11C314DC0D775B38A334B41C02546AA041F314DC0169341E7314B41C02A608B0120314DC0843BBD1F314B41C05C26CAB926314DC0A1A8C6182C4B41C04101E2272C314DC0715B8A40294B41C0D9B9F61138314DC0D8DE72FD204B41C04308A72E40314DC0E3ADDBA5104B41C03D47697741314DC0795411FB0D4B41C0B4BEAF9F46314DC0732B1643034B41C0E9D79C704A314DC00C94215FFC4A41C089CF991E51314DC08498EB92EF4A41C04823F11457314DC08B2BD64EE74A41C0596A32C362314DC03B673222D94A41C09952CBF66D314DC06DC6BCEECC4A41C0B32F1C4D79314DC087E1CC65C04A41C07C3339BE7C314DC087202B98BC4A41C0CEB7FF7787314DC0B65B0FC5B14A41C0759C0DAB89314DC0AC1B4A16B04A41C06982E7019B314DC0279F72D0A24A41C0555EE131A4314DC0CAB6E2629B4A41C0D08DC671A6314DC034029190994A41C016FC688CB3314DC01638FAE8904A41C0C6CA563FC8314DC032ABF56D854A41C01E8BD194D7314DC0112B000A7D4A41C0EFEB16DFED314DC01F8EC004714A41C019AE8B9BFA314DC07C0159D26A4A41C0499E7D930C324DC0EC6EEA3D614A41C0A9FF20AC15324DC05B06425C5C4A41C0FBCDB67E1C324DC012E704EB594A41C0D11DA36A21324DC087342D60584A41C0CC352369F8314DC0916EEF731B4A41C094CCF0D0E8314DC02DD8B447044A41C0151CB517A6314DC063A02169004A41C0087E4101A1314DC08F380425004A41C08208BF829B314DC04890C8BBFF4941C0258E1F0A92314DC010CB4406FF4941C03FB28A4E81314DC01F1327A3FD4941C05E49E10F7E314DC07C85DAC8FE4941C0BF11E00D7A314DC09033F00B004A41C0D870F5F377314DC0B6B008B5004A41C0363BD2766C314DC0BB1E99BE024A41C076D27BE067314DC0852A0FD6024A41C006E71AFA60314DC01FFCFFF9024A41C0D49551815E314DC01FD699F9024A41C0AEABE33B54314DC085723908044A41C0085066DF52314DC06D878F2B044A41C0F131346B49314DC09F50C2EC034A41C05BAA2AC733314DC0B9F0A23E024A41C051CC1A862D314DC0464752C2014A41C06F0660C422314DC01D497E30024A41C0C43DC79D18314DC00C5F5E9B034A41C0","RETIRO",16401.9814768,3262096.05041,5275,3131,2144,1,46
6,"0106000020E610000001000000010300000001000000150000005B35931F93314DC06F86A8F11C4C41C0983BB7A69B314DC073C83CEAE14B41C07465CE03A7314DC0CFA9F941BC4B41C07DA97951A8314DC044251C2EBB4B41C0EFF0CF00A8314DC0FBF3FCE9BA4B41C0BE75B36186314DC066B51B839E4B41C035A3151786314DC0FB862E389E4B41C0DB438B9366314DC0A5326A607E4B41C04BC492CA23314DC0D2F022793B4B41C07B7985A121314DC06FF5E8F8384B41C0920905E094304DC0E4A12CFD854B41C0C3BE021E57304DC00E466E97AC4B41C0F90E306937304DC0A86C3797C14B41C072BDD3C545304DC0A7D048E2E64B41C0FC0D12AC54304DC0598AB8620B4C41C06C137595D1304DC05ACCA3270D4C41C0C61C7CA6D7304DC038CF2EDB0D4C41C04EB4F23507314DC00E2C7D5D134C41C0376C7FB134314DC04C139133164C41C0612B55DA62314DC048E307291A4C41C05B35931F93314DC06F86A8F11C4C41C0","RETIRO",2878.66943094,506278.298646,17159,7661,9498,1,46
7,"0106000020E61000000100000001030000000100000010000000BC6C224CCC304DC0DCF08229AD4C41C0F1ADC811CD304DC03859BC32AD4C41C04860A6AD84314DC0381ACA93B54C41C0D2AFA6E587314DC063E62145944C41C06A3CAD2E8B314DC0E0A1CF04714C41C0740505018B314DC0CCCD003D6C4C41C06DE438E28D314DC0363C5E34414C41C05B35931F93314DC06F86A8F11C4C41C0612B55DA62314DC048E307291A4C41C0376C7FB134314DC04C139133164C41C04EB4F23507314DC00E2C7D5D134C41C0C61C7CA6D7304DC038CF2EDB0D4C41C0F5D30DE4D2304DC01139ECED414C41C06575B52ED2304DC0B22C6E5D614C41C051BA586ECF304DC0CD764FBB844C41C0BC6C224CCC304DC0DCF08229AD4C41C0","RETIRO",2103.3810586,274045.262286,9011,4132,4879,1,46
8,"0106000020E61000000100000001030000000100000018000000A14D336BD72F4DC08F45596B014C41C0BD688CC6BF2F4DC09EFC8A29194C41C0D6187DF1A52F4DC0008393164E4C41C010E1901F972F4DC05179C8346F4C41C017D5CF6F842F4DC092177352984C41C0F77F29868D2F4DC0ACB022FF984C41C06D9A9CD2B72F4DC05DA79D239C4C41C0EA00F5810D304DC012EF9962A24C41C0A7E82BC66B304DC0399C78CBA84C41C08F16406F9B304DC0EBAC5CEEAA4C41C0BC6C224CCC304DC0DCF08229AD4C41C051BA586ECF304DC0CD764FBB844C41C06575B52ED2304DC0B22C6E5D614C41C0F5D30DE4D2304DC01139ECED414C41C0C61C7CA6D7304DC038CF2EDB0D4C41C06C137595D1304DC05ACCA3270D4C41C0FC0D12AC54304DC0598AB8620B4C41C072BDD3C545304DC0A7D048E2E64B41C0F90E306937304DC0A86C3797C14B41C0050867D306304DC0F3716EC3E14B41C0FB386942DC2F4DC06E1D488FFC4B41C0DCE70DA0DB2F4DC0E6638C32FD4B41C04D17A3F2D82F4DC0D262B3E5FE4B41C0A14D336BD72F4DC08F45596B014C41C0","RETIRO",3002.23193403,486243.036965,9483,4904,4579,1,46
20,"0106000020E610000001000000010300000001000000020300009644B42836334DC060294793E24841C05C84023437334DC084A065B5E04841C0D8E0B9B234334DC0FBCF0130E24841C0B740F53B32334DC01D7331D1E34841C09775A3C41D334DC067CCEE5EF14841C0AE462A8706334DC0CCD42359FD4841C0BAB8139AF9324DC01F967CB3044941C00F60CBA2F4324DC09F64A786074941C0B6E25E50DE324DC0A707A74E144941C0999FDC85DB324DC0055875E7154941C08D0D3E03C1324DC0AFF7C415254941C01ACF1B9DAA324DC08F4A27BD314941C02429A75C94324DC04D849B4E3E4941C07F6FBF278F324DC0318430DA3F4941C064B6DEE788324DC01A24FF54414941C025F475077A324DC08313ACE0404941C0F412E1046C324DC07D88C901404941C083C29E0663324DC071EDE0223F4941C0A46BCE7D54324DC03AAD29433E4941C0671285F046324DC0837410053F4941C0E03FD07346314DC0BD0CF984CA4941C0BF37EC8A3E314DC05DEB7711CA4941C019400CBD13314DC0D2FFFAA1C74941C0938F4D1003314DC0FDFB4E12B24941C09D7E537202314DC07847A66AB04941C0EDFF163102314DC08CD85FEAAE4941C06C55686602314DC0027879BEAC4941C00CE1C15603314DC0C84F5FA6AA4941C0B231353005314DC084F08B43A84941C0B917DBF107314DC008EC5955A64941C01373B46D0B314DC0BC2744A2A44941C0352E912B16324DC0291015D80A4941C01031D9E916324DC02B2B8AB9094941C0F141D06217324DC0EBCBB560084941C0BAD9E81F17324DC09AD71167074941C003B7A69716324DC01CBE1046064941C015CA52C10D324DC0DD893D19F84841C0C162B7990B324DC03A688B2FF64841C04E9A272209324DC0F4815366F44841C04E9D4DE605324DC0AC4C6D81F34841C02D14404601324DC0F04AC7C1F34841C07F9B79AAF2314DC00AE49A9FFA4841C040AC30ADCA314DC0FE4603A8004941C092CAD319C1314DC076FECD83024941C0788BDDB4B4314DC0A5FFEA6C0A4941C01723A11CA2314DC0E3ADCFA9144941C01E2865698D314DC0B024EF03144941C000C0231975314DC0EECA811D124941C0BA69767072314DC0C5D5A2FF134941C080F444EA6C314DC0293F9279114941C06043CF98D3304DC0F1745F7D054941C01FA7EB86C0304DC0892DA7DE034941C07606B90EC0304DC0F11B3BFD044941C08C157AF4C0304DC00766290C064941C052A93425D0304DC0A59B9C80074941C0EDD03D49D0304DC0962577400B4941C08EFAE9A7BC304DC03FA59022164941C04CB38EA2B6304DC018E150A50F4941C0045B2BD1B7304DC0CB478CE8054941C05CF7C8F9B7304DC014954554034941C057D85F41B4304DC0CBAC3604034941C0F37CA75494304DC09D065280004941C08427803994304DC02CF8077E004941C067D89A1D94304DC002F7BE7B004941C027C0740294304DC03B23337A004941C085D74EE793304DC051A0EC77004941C065F028CC93304DC0F934A075004941C045D702B193304DC07BEC1774004941C04F871D9593304DC08176D271004941C0DB32F67993304DC04BDC846F004941C0C419D05E93304DC0A893FC6D004941C073E8AF4393304DC07FB4B36B004941C0CB008A2893304DC0D3A56969004941C004CA9E0C93304DC0A43AE167004941C014E278F192304DC05B5A9865004941C072FA52D692304DC08A4B4E63004941C01B2A31BB92304DC0D631C761004941C072DB4B9F92304DC084017D5F004941C08DF3258492304DC00A21345D004941C08ADAFF6892304DC0F9D7AB5B004941C0ABF2D94D92304DC063F76259004941C06636F33192304DC0A1C61857004941C06A1DCD1692304DC0697D9055004941C09435A7FB91304DC0B29C4753004941C00D4E81E091304DC0748DFD50004941C0CB345BC591304DC09372764F004941C03DE675A991304DC0D3412C4D004941C0C7904E8E91304DC0A960E34A004941C0D977287391304DC02C175B49004941C06090025891304DC0B0071147004941C09EA8DC3C91304DC0A326C844004941C0AB28F72091304DC094BB3F43004941C0EE40D10591304DC06EDAF640004941C08259ABEA90304DC0C1CAAC3E004941C0A24085CF90304DC0FB80243D004941C01D859EB390304DC096F2D73A004941C0D29C789890304DC0336E9138004941C00BB6527D90304DC063014536004941C0369D2C6290304DC06BB7BC34004941C0A6B4064790304DC05D617732004941C02667212B90304DC07FA42930004941C0594EFB0F90304DC0655AA12E004941C0B866D5F48F304DC0C678582C004941C0677FAFD98F304DC09F680E2A004941C0EA91C8BD8F304DC0AEFC8528004941C050AAA2A28F304DC0EB1A3D26004941C0070C81878F304DC0600BF323004941C0FBF25A6C8F304DC074EF6B22004941C0B80B35518F304DC015DF2120004941C021744B358F304DC0EDDAD81D004941C0685B251A8F304DC06290501C004941C0DEBC03FF8E304DC017AF071A004941C0A7D5DDE38E304DC0839EBD17004941C03EE8F6C78E304DC020323516004941C0C000D1AC8E304DC0EF4FEC13004941C09219AB918E304DC0393FA211004941C09A0085768E304DC0DF221B10004941C071195F5B8E304DC00F12D10D004941C0F2CA793F8E304DC03B0E880B004941C04DB253248E304DC044C3FF09004941C02ECB2D098E304DC051B2B507004941C0C5E307EE8D304DC0C9CF6C05004941C0A9FCE1D28D304DC0BEBE2203004941C00C0FFBB68D304DC058809B01004941C0F727D59B8D304DC0356F51FFFF4841C09940AF808D304DC07F8C08FDFF4841C0052889658D304DC0304180FBFF4841C0EBD9A3498D304DC0720E36F9FF4841C07FF37D2E8D304DC029A0E9F6FF4841C009DA57138D304DC026E064F5FF4841C0B9F231F88C304DC032FD1BF3FF4841C09F5510DD8C304DC00C61CEF0FF4841C0B74F25C18C304DC0F3E688EEFF4841C01C38FFA58C304DC0E50FFDECFF4841C02651D98A8C304DC048FEB2EAFF4841C0E2B2B76F8C304DC0D91B6AE8FF4841C0EFCB91548C304DC0210A20E6FF4841C06C4CAC388C304DC0D39C97E4FF4841C03165861D8C304DC080B94EE2FF4841C0487E60028C304DC0A5A704E0FF4841C014973AE78B304DC037C4BBDDFF4841C0EFA953CB8B304DC07A5633DCFF4841C0C0C22DB08B304DC0F572EAD9FF4841C0E2DB07958B304DC0E760A0D7FF4841C0BCF4E1798B304DC04C7D57D5FF4841C054DCBB5E8B304DC01931CFD3FF4841C0748ED6428B304DC06BFD84D1FF4841C055A7B0278B304DC0AA193CCFFF4841C0F68E8A0C8B304DC051CDB3CDFF4841C0DAA764F18A304DC078E96ACBFF4841C05EEC7DD58A304DC05AB520C9FF4841C0470558BA8A304DC065D1D7C6FF4841C0F2EC319F8A304DC0DD844FC5FF4841C033060C848A304DC05B7205C3FF4841C0271FE6688A304DC0428EBCC0FF4841C060D1004D8A304DC0235A72BEFF4841C01C4BD9318A304DC0A53BEBBCFF4841C06864B3168A304DC0F128A1BAFF4841C0657D8DFB89304DC0AA4458B8FF4841C0CB1B6DE089304DC0CCF8CFB6FF4841C01D1782C489304DC0E8F186B4FF4841C05B315CA989304DC0995339B2FF4841C03618368E89304DC00192B4B0FF4841C04131107389304DC07EAD6BAEFF4841C0D576295789304DC043ED1DACFF4841C00F14093C89304DC0045B9AAAFF4841C05C2EE32089304DC074BC4CA8FF4841C02916BD0589304DC0366FC4A6FF4841C09CC195EA88304DC0368A7BA4FF4841C066F9ABCE88304DC0981AF3A2FF4841C0D55B8AB388304DC00508A9A0FF4841C0F874649888304DC02223609EFF4841C06D8E3E7D88304DC0B60F169CFF4841C0F00E596188304DC01FCF8E9AFF4841C0C0BA314688304DC05DBB4498FF4841C0F1D30B2B88304DC047D6FB95FF4841C073EDE50F88304DC0ABC2B193FF4841C09F9F00F487304DC0F4BB6891FF4841C026B9DAD887304DC03FA81E8FFF4841C011A1B4BD87304DC0715A968DFF4841C04DBA8EA287304DC01D754D8BFF4841C028FFA78687304DC07A3F0389FF4841C0CDE6816B87304DC0FF1F7C87FF4841C0C0CE5B5087304DC000D2F385FF4841C0B4B6353587304DC0F2836B84FF4841C05437501987304DC0C742E482FF4841C04D1F2AFE86304DC0A2F45B81FF4841C0490704E386304DC070A6D37FFF4841C0EFE81CC786304DC057FC0C7FFF4841C0FC9EF6AB86304DC076A2477EFF4841C05655D09086304DC0121A817DFF4841C0B20BAA7586304DC0A191BA7CFF4841C06029C45986304DC086ADB57CFF4841C015AE9D3E86304DC0EBEAB07CFF4841C0CA32772386304DC04528AC7CFF4841C0CFE28F0786304DC0C443A77CFF4841C0DD3569EC85304DC0F546647DFF4841C08A5383D085304DC09B625F7DFF4841C096A65CB585304DC0B4651C7EFF4841C0F1F9359A85304DC0493AD87EFF4841C049784E7E85304DC0771B957FFF4841C0A799276385304DC05EE41381FF4841C0A685414785304DC0B3C5D081FF4841C051A71A2C85304DC007604E83FF4841C0AAC8F31085304DC0C828CD84FF4841C0F8820DF584304DC0E9CF4B86FF4841C0A436E5D984304DC05298CA87FF4841C09926BEBE84304DC063F8098AFF4841C0EB4797A384304DC0F5C0888BFF4841C0D0D0B08784304DC059FFC78DFF4841C01DF2896C84304DC0D2C7468FFF4841C057B0625184304DC0A2ED4792FF4841C0EF9F3B3684304DC0F37B8894FF4841C0225E141B84304DC0AEA18997FF4841C0021CEDFF83304DC0D6F58B9AFF4841C07BF1C9E483304DC028E24E9EFF4841C0A1AFA2C983304DC0BF0750A1FF4841C0113C7BAE83304DC038F312A5FF4841C044C7539383304DC08D98DAA8FF4841C09EBBEB7883304DC0181A9AACFF4841C01747C45D83304DC0DB9060B0FF4841C0BFA19C4283304DC01842E5B4FF4841C0162E752783304DC0532DA8B8FF4841C01803520C83304DC0C2476CBCFF4841C01BC12AF182304DC0F66C6DBFFF4841C0634D03D682304DC00F5830C3FF4841C0A6D9DBBA82304DC01E43F3C6FF4841C05297B49F82304DC0A796F5C9FF4841C042558D8482304DC0ACBBF6CCFF4841C03313666982304DC0A4E0F7CFFF4841C089023F4E82304DC01B6E38D2FF4841C072C0173382304DC0FE9239D5FF4841C0087EF01782304DC04BE63BD8FF4841C0E93BC9FC81304DC0140B3DDBFF4841C0302BA2E181304DC05A987DDDFF4841C009E97AC681304DC00BBD7EE0FF4841C0D18898AA81304DC0D3C07FE3FF4841C0BC7A309081304DC0DD8647E7FF4841C07039097581304DC0FE1F45EAFF4841C093C4E15981304DC0DC950BEEFF4841C0D91EBA3E81304DC0314690F2FF4841C08DAA922381304DC0015F54F6FF4841C0D86B2A0981304DC0DE30D9FAFF4841C0CA4007EE80304DC0DC1B9CFEFF4841C0FD9ADFD280304DC002CC2003004941C0345C77B880304DC0BD9DA507004941C05CB64F9D80304DC0C64D2A0C004941C07D10288280304DC0C9FDAE10004941C04D3FC16780304DC09DCF3315004941C0A067994C80304DC077457A1A004941C0B971353280304DC0B617FF1E004941C0FD990D1780304DC0768D4524004941C00D5BA5FC7F304DC0DE5ECA28004941C0ED3983E17F304DC088D5102E004941C0F1FA1AC77F304DC0D7A69532004941C01C23F3AB7F304DC0681CDC37004941C064B18A917F304DC0FF3E263D004941C0470B63767F304DC087EEAA41004941C01351005C7F304DC09A86F146004941C02479D8407F304DC0FCFB374C004941C08A0870267F304DC07C647D51004941C08C30480B7F304DC0C7D9C356004941C09608E4F07E304DC06B710A5C004941C00B377DD67E304DC095428F60004941C0FB5E55BB7E304DC0B9B7D565004941C0F0EDECA07E304DC07A4E1C6B004941C088338A867E304DC031E66270004941C09829626B7E304DC022216B76004941C08FB7F9507E304DC02F43B57B004941C06B4691367E304DC0BFD9FB80004941C0B13C691B7E304DC016E60287004941C0278206017E304DC0927D498C004941C021DF9DE67D304DC0F3D95192004941C0133C35CC7D304DC048365A98004941C0F24FD2B17D304DC01965619E004941C0D3AC69977D304DC056C169A4004941C056C0067D7D304DC08A1E72AA004941C0291D9E627D304DC0AF7A7AB0004941C08A4735487D304DC0AFF946B7004941C026E0CD2D7D304DC0F01B11BE004941C0C8282A147D304DC09160DBC4004941C0F653C1F97C304DC00154A4CB004941C0CDC75CDF7C304DC09F766ED2004941C0A5C7B4C57C304DC0E58B37D9004941C0427751AB7C304DC09F74C3E0004941C05F09A8917C304DC08D898CE7004941C0EB6F40777C304DC0717118EF004941C0C9869C5D7C304DC03B4DA3F6004941C0C02EF7437C304DC0A2E232FE004941C07C958F297C304DC0E89BBD05014941C040ACEB0F7C304DC09377480D014941C02CDA41F67B304DC09B469615014941C0DEF09DDC7B304DC02E22211D014941C0B08CF5C27B304DC0E7C26D25014941C0287151A97B304DC0D292BB2D014941C0F4BC6C907B304DC0E6550836014941C0BD57C4767B304DC0EC81583E014941C08B0A205D7B304DC02AE96647014941C0EC553B447B304DC09CDAB44F014941C0A5BF922A7B304DC00541C358014941C064D9AD117B304DC0D5C9D161014941C01AF3C8F87A304DC09C52E06A014941C0C20CE4DF7A304DC058DBEE73014941C075443BC67A304DC08707BF7D014941C01F5D56AD7A304DC09C1BD186014941C077B272947A304DC06A6AA190014941C0F4CB8D7B7A304DC0FDF2AF99014941C088B3A8627A304DC0764180A3014941C09A3AC5497A304DC038CA8EAC014941C01822E0307A304DC09C185FB6014941C035F1F6177A304DC02B5A72BF014941C0E9D811FF79304DC0037A41C9014941C0D8F12CE679304DC0D33051D2014941C0F45A84CC79304DC0AA965FDB014941C03B429FB379304DC0DAE42FE5014941C0FEC8BB9A79304DC0526D3EEE014941C00FE2D68179304DC080F54CF7014941C014FBF16879304DC0A17D5B00024941C02E31494F79304DC0A1342F0A024941C01D4A643679304DC0ADBC3D13024941C002637F1D79304DC0B3444C1C024941C085E99B0479304DC0EDCC5A25024941C06ED0B6EB78304DC0CC1A2B2F024941C074CB0CD278304DC0F87F3938024941C09D5029B978304DC0F9C14C41024941C0B43744A078304DC03FE11B4B024941C007505F8778304DC081972B54024941C0B1A47B6E78304DC0F4B6FA5D024941C05942925578304DC0D603CB67024941C0DA5AAD3C78304DC07E8BD970024941C06841C82378304DC00CD9A97A024941C072FBA30B78304DC073027F84024941C0EAE1BEF277304DC0EC4F4F8E024941C0A5C8D9D977304DC0E36E1E98024941C0DA51B5C177304DC035A4B0A2024941C02F38D0A877304DC08EF180AC024941C04EC1AB9077304DC0CF2613B7024941C0B9DC857877304DC0C45BA5C1024941C0D664616077304DC05A1C3BCC024941C01DEE3C4877304DC00323CCD6024941C077D7163077304DC0CA1D20E2024941C05760F21777304DC0D952B2EC024941C08EB7CDFF76304DC0551F05F8024941C081BE6CE876304DC0C13C5903034941C0A5A746D076304DC06337AD0E034941C0E664E1B876304DC0EEB0031A034941C099BBBCA076304DC0BCAB5725034941C05B79578976304DC044C8AB30034941C044D0327176304DC08694FE3B034941C0FAA4D15976304DC0AA771448034941C0AC616C4276304DC0821F6C53034941C096ED062B76304DC05BD3805F034941C017F4A51376304DC074F0D46A034941C0E57F40FC75304DC03BA4E976034941C04D3DDBE475304DC07FC03D82034941C003127ACD75304DC0F574528E034941C05E9D14B675304DC01857689A034941C00E28AF9E75304DC0279680A6034941C013D10E8875304DC0FF9A96B2034941C0925CA97075304DC08C4EABBE034941C00FFF475975304DC0C6C881CB034941C057F0A14275304DC0EE579BD7034941C00A32422B75304DC0DF3AB1E3034941C07BF29B1475304DC000D687F0034941C0B77D36FD74304DC063899CFC034941C05F2696E674304DC0FD8DB208044941C0DE112FCF74304DC0FD068915044941C080B98EB874304DC0F596A221044941C0874429A174304DC0344AB72D044941C04FBB888A74304DC022E68D3A044941C092ED015E74304DC03DD5FB51044941C0B8E4AF8924304DC028471749314941C0ACE704BA1C304DC0AE07E5AD354941C0E8D675BC1B304DC083F88849364941C05596FECD1A304DC053EB2AE5364941C0BB395C7719304DC04CC811C7374941C02501A28C18304DC07907E677384941C051D2393217304DC074720875394941C0E90DDE8616304DC089845F053A4941C019A1840016304DC0112F52813A4941C032BEBC8A15304DC0E52F00FB3A4941C02418A9C214304DC0D2ADDECA3B4941C0BF638A1914304DC01C42188A3C4941C0902F958E13304DC03EEBFD3A3D4941C0E6A0700A13304DC08F0909DF3D4941C0C9ADB27E12304DC0706E6BAD3E4941C08A55A2E711304DC0C27F04973F4941C0E2C8F04511304DC02B06A0BB404941C07BE0F1A410304DC05A63DE0F424941C00065200010304DC0AB7ED099434941C0005453830F304DC0637822F4444941C01DFD47260F304DC0B133EB0B464941C0F1CB38F70E304DC0F7347821474941C079925A920E304DC0B0C8683A494941C0FC742C470E304DC0ADCE5E344B4941C0AF8DC10B0E304DC07AF2E7734D4941C0D89CDDCE0D304DC0F9520C834F4941C08F8FDD5D0D304DC052C78BA8544941C074D547560D304DC0342777DA544941C06E8BA2450D304DC0DD515006554941C09EA6EA1F0D304DC005E16C15554941C01995F4C90C304DC0A222500F554941C04725B9710C304DC0C6273409554941C00FAEF2110C304DC0B80F05FD544941C0BCFE935107304DC0A858A8A3544941C0803BC72205304DC04C712E7B544941C057101D9303304DC0A7331858544941C098D841E201304DC057BB0138544941C07162D499FF2F4DC033B0370A544941C0713006C4FD2F4DC09F4E1AEA534941C0059CB693FB2F4DC0F17874CB534941C0C19C782AFA2F4DC06196DFC2534941C0B1EC5AA8F82F4DC02DF41BC4534941C033D95D92F62F4DC0A7D56FDD534941C038B6383EF52F4DC0C358EDF9534941C0FF5515C5F32F4DC06FB1D22A544941C0BDB6402CF22F4DC004596775544941C0BFDF92DCF02F4DC01BE548BF544941C005ED7D72EF2F4DC0D259B10D554941C0E0535ADAED2F4DC0DE54368D554941C04392F645EC2F4DC0DA90A31C564941C0ED2046D4EA2F4DC00AE05EB1564941C0B511C836E92F4DC0D4C9F171574941C058CAA853E82F4DC0BD09D4ED574941C00212B3C0E62F4DC0AAE5CCBF584941C028380A89E52F4DC051019873594941C0DD9350F2E32F4DC0677839595A4941C00F51D05AE22F4DC0EABFDA3E5B4941C01D4C31B8DF2F4DC032F792BB5C4941C0CAD8BF51DE2F4DC0F148B9805D4941C0494E6F9D912F4DC0E52FDA27894941C05CEF75958F2F4DC036A25B618A4941C0E8F105DF8D2F4DC0129D275F8B4941C004DAC8718C2F4DC0C131C7228C4941C0EDF535D18A2F4DC037C2360F8D4941C022BC504A892F4DC0D3803CE78D4941C083B789B0872F4DC020BE36D88E4941C0AD43A95A862F4DC037E325A18F4941C0771A1E10852F4DC0D2D0A16E904941C0169D7B09842F4DC0315BCD11914941C07024B1C5822F4DC05FBA7FF7914941C08A32FFBE812F4DC0FBBE4CC7924941C0C8262EF0802F4DC0CB0B1772934941C0EA97F43A802F4DC0065B072F944941C0F4390C8B7F2F4DC065B728E2944941C025C607F47E2F4DC093B46382954941C0014EE52B7E2F4DC0C4E38B76964941C03B670C287D2F4DC0899E89F0974941C06DD8604B7C2F4DC01AFB568D994941C0C0D1AED47B2F4DC03A20EE8F9A4941C0C10D4D4A7B2F4DC0E6412FE49B4941C08DA011F47A2F4DC0F508D8CD9C4941C0C0A4F7B27A2F4DC0678B8B9E9D4941C0AC731A777A2F4DC0749908AE9E4941C09CCD704D7A2F4DC0975B0D499F4941C04A717A147A2F4DC0EFAAE5BDA04941C04D33B7D4792F4DC0EFC13631A24941C04C9A6A7C792F4DC07F925A13A54941C076259832792F4DC0F68ADF6EA74941C09C222EB4782F4DC09D3BA2C6AB4941C0B70D13D27B2F4DC05AEF03EAAB4941C0E94CD9517C2F4DC0FA337720A84941C069C1F3CA7C2F4DC04F7867DFA34941C088319A0B7D2F4DC0C65F8BF1A14941C07DCAD1657D2F4DC02851B03BA04941C0DD4648C57D2F4DC0EA9BE9AD9E4941C05935412F7E2F4DC0DB958A509D4941C0F6AF7E857E2F4DC03426575F9C4941C07B5CB5FA7E2F4DC024DE0C469B4941C0D0791E6F7F2F4DC0EF0ADE549A4941C03DB6B8E27F2F4DC0B4459895994941C06595804F802F4DC0AA4C99F7984941C061BE4EBF802F4DC0C957E33F984941C087854C2B812F4DC05CAE94B8974941C02E0F9FC4812F4DC05AF554F9964941C0B74AD279822F4DC06A38A53E964941C061057527832F4DC0A4DBB3A0954941C0CB191CD8832F4DC07C6E4504954941C0DB84D6E7842F4DC015573835944941C08182EBB8852F4DC02D119399934941C0F447A5A3862F4DC043D529FA924941C0BA8177C8872F4DC0E61C5743924941C079CA541E892F4DC0BA119F76914941C0FCFA76768A2F4DC017FA6AAB904941C0CB5D34388C2F4DC0CB153ABB8F4941C07B43809B8E2F4DC0736713498E4941C07ED1E39B902F4DC0B98521368D4941C027231441E62F4DC00758592F5C4941C0660EAC6FE72F4DC0336962855B4941C06BB56460E82F4DC091A42BFE5A4941C083DF0948E92F4DC0D78E298F5A4941C0225FDD75EA2F4DC0469E5AF7594941C094799869EB2F4DC050AF7678594941C0E67C7F2BEC2F4DC0D33A392F594941C052BBA617ED2F4DC09B62CECA584941C0F839BB1FEE2F4DC036B0CE5B584941C0B850F845EF2F4DC0648F6EF7574941C0A81D7B21F02F4DC007B5C8B5574941C0C14A1B90F12F4DC0BCD79560574941C010FFE7F4F22F4DC0CCD0A810574941C04EEB3661F42F4DC0CBC0BEDC564941C0C7A2AE6FF62F4DC04BCFA3A3564941C05F2C456BF82F4DC072330288564941C01D0745D2F92F4DC0DBC9697B564941C055E91277FB2F4DC07B919C8B564941C0B8E2B128FD2F4DC041E38296564941C003642691FE2F4DC0B5E403B5564941C02B32982100304DC0FBF103CF564941C00D5EB70202304DC0562722EF564941C05E43D8B503304DC0107D2809574941C03C38E95F05304DC001B6872E574941C0A1EA0C7207304DC0ABFA6C4F574941C0B7EC776F0A304DC09A2CE07E574941C0C7151EB10C304DC0A51DACAC574941C08C61A0220E304DC0BAB029C8574941C0F53C806310304DC0B7CF7EFA574941C088F2039910304DC09926884F554941C096C0E0B610304DC01BED5594534941C04439F6D610304DC0F0B2A918524941C040FED4FD10304DC08C3D4E86504941C033300C1A11304DC0D782356C4F4941C03FB52E3611304DC0535A158A4E4941C0630D955111304DC09581D79B4D4941C07DB5FE6F11304DC05BBF03A34C4941C0905F678E11304DC05EDC92B84B4941C0B7840DAF11304DC05C73A0EB4A4941C0F4B7B0CC11304DC069F1291D4A4941C0171848E411304DC0C400D341494941C0D3A3E60112304DC0C48CC084484941C0A6885B3212304DC0D58B4BD2474941C062626E6A12304DC018F69BC9464941C0B598269D12304DC006256919464941C00FC84FE712304DC0C9B1E222454941C0D3EFDD2C13304DC0A9EB1A84444941C0F4860E8013304DC022D004A2434941C030492DCD13304DC01307EEDE424941C04F9E833E14304DC0E9580A12424941C0DD1AD7A914304DC078EC0D3C414941C082E6A53E15304DC003526049404941C0A283C8B915304DC0791C608C3F4941C0E4E08C7316304DC0527A11A53E4941C06763080617304DC038B7BDFB3D4941C074F599AA17304DC06DED27503D4941C0E026A26F18304DC0F08A44993C4941C02140044619304DC0FD1499DE3B4941C0AB818B0F1A304DC0C5F4BF2D3B4941C0F8C613011B304DC0C6C89B743A4941C02A36AFFE1B304DC0A5478CA5394941C0DA854FDD1C304DC0422B0619394941C09893FAEC1D304DC0CEDBCD6F384941C062F0C7111F304DC0438036B8374941C06AC6201620304DC0C0A72624374941C01212942C21304DC0721D307D364941C08263A88422304DC0E03EEDCA354941C0505FD67023304DC0B3BC4148354941C062440B3824304DC0697B93E7344941C068E04D9024304DC019FEB5D1344941C03D19733774304DC050A517A4074941C040CD7BD975304DC0DA8F5BB2064941C02AFD802877304DC01A211B03064941C0C14A269178304DC002BB6255054941C0C6CE2B9079304DC0036117E1044941C0AB6757AA7A304DC09F81AE5D044941C0C4B99D827C304DC06045E4BC034941C0A782B0C17D304DC0D8302266034941C0C74D76CA7E304DC0ED01FA1F034941C012929D4380304DC0D70055D2024941C04E35617A81304DC01EAF4D98024941C018FC6AB682304DC0ECF41B68024941C0A47BAACE84304DC0B69BC532024941C06D94BA1986304DC0CE86AE2A024941C0502463A387304DC0EBC1312A024941C0BD38792289304DC0F0D7DE3E024941C022E5BE218B304DC036864A64024941C0F8C4E3BDB4304DC0A0708EB1054941C01ECF00C0B4304DC05B1E374A0F4941C00C613217BB304DC0F234C62B174941C0A71D36626D304DC0DAC78A80404941C086F2A4016D304DC09EE9E2B0404941C07FB5278B6C304DC05E24BB01414941C0753930416C304DC0D1A5C045414941C04C72D8106C304DC04119978D414941C0C63298EC6B304DC06BF2B6BE414941C0857EB3DC6B304DC08B4430F8414941C0A144DAB06B304DC008F1FA58424941C0F1586FA26B304DC01D2269AB424941C04E2C67616A304DC055EF9A6E4D4941C0F211DA6E6A304DC0811876F14D4941C0E062258C6A304DC0A1B9DA594E4941C09DF9C6B16A304DC09D22DFB04E4941C082D3ECDB6A304DC01C6D44FA4E4941C04BED6B146B304DC01E2AA5404F4941C02CCD0D686B304DC081A02A964F4941C0187EABB56B304DC01FD1ECCB4F4941C0D06C9D116C304DC0D7C5FC06504941C0FE13516B6C304DC03119C13C504941C0F61622DA6C304DC0AB5F2061504941C0DEAAC34F6D304DC0B5CBA978504941C0A4C174026E304DC0F9280F9A504941C04F62ADB06E304DC056C0FCA0504941C06F1A90B26F304DC042971CB7504941C048AC293671304DC03B876EDC504941C01BE15F5117314DC091ABAE1B5E4941C00725291018314DC0D107961F5E4941C089C47EAB18314DC0CE3DA3385E4941C029C4AD0019314DC05C16475F5E4941C021C28B4719314DC0311B6C8A5E4941C081D4887B19314DC09F09D8B75E4941C023D2FBAA19314DC08E2156EE5E4941C02DD821CF19314DC0FAB7612C5F4941C086AAEBE119314DC0FDF8ED6B5F4941C0FAD192DF19314DC0930226C25F4941C0F46E27D119314DC098838C2D604941C0E405CF6E19314DC0A58D5888644941C09C6DE15B19314DC065B349DC644941C0CF76014F19314DC018ED8E19654941C0E78B634419314DC0EEEDF94C654941C02CF9702B19314DC09D4A018E654941C003DFFCE518314DC075D084D0654941C06382B69018314DC053CBF209664941C0E0F5783E18314DC0B1FDBE32664941C0EC41FDEF17314DC023F34F5F664941C0730595CCE1304DC0E648C01E854941C08E1E4B77E1304DC02B6C4464854941C0EBC8E70CE1304DC0469A9B94854941C08E3355ACE0304DC0D0AC3FCA854941C003777446E0304DC0974D6C04864941C0E27743FDDF304DC06CBB2C27864941C08DFCF7C9DF304DC00B50B931864941C0AFB8DE8CDF304DC04369453C864941C0A6A19E34DF304DC017E7CC46864941C02E24D19DDE304DC0C19EC430864941C0A1FF58BCDD304DC05D619A11864941C0893EE57A24304DC00F78084B774941C0F75A81D910304DC03A5263BD754941C098F64E5E0E304DC0B499D061764941C0DA2B9A21C82F4DC0980479B49E4941C00CEDF316752F4DC0B44585F6CD4941C0DA82F5EE742F4DC01B416C0CCE4941C0B9B91BB7742F4DC08C243A35CE4941C0075F2495742F4DC05B333554CE4941C073206E7B742F4DC09ED01B86CE4941C045840567742F4DC05B8B0ABBCE4941C00CF6AC61742F4DC0774503F3CE4941C0382695F5722F4DC0C1DA4DA3DB4941C0AA3FC0F4722F4DC05C5E67EADB4941C086034B05732F4DC02146A724DC4941C0D1415517732F4DC0A5F7A05CDC4941C08E6F3536732F4DC0ED37FD83DC4941C064ADE061732F4DC0247349C1DC4941C028A539AA732F4DC071D80BF7DC4941C0EC4CDDF7732F4DC0B305DD16DD4941C010A54746742F4DC08911192CDD4941C028266B8C742F4DC057476E2EDD4941C0301311D4742F4DC096C85038DD4941C084FF515D752F4DC0FE297E41DD4941C0118315EF20304DC015E0D4D3EA4941C0F60B1A4E21304DC0156E7BDEEA4941C02F4E049B21304DC08D6A96E4EA4941C0D503FCF021304DC0F4BA7AEEEA4941C064C1F41B22304DC01D0126FFEA4941C0539A79F922304DC0F0470ED0EB4941C097351D7B22304DC07718EB33F04941C0C0F5264822304DC0438C8FCBF14941C073A9AD3022304DC01F612530F24941C02155F11322304DC0F081E76EF24941C087DCB6EF21304DC0167E3F9CF24941C0014D84A921304DC0572BE7D1F24941C06F7EA84921304DC0ED179D10F34941C0EC70D895FE2F4DC032A1A0B7064A41C0B5CCE9C2E92F4DC0C89FF182124A41C01952FD81E92F4DC0827909B1124A41C04BACFD2EE92F4DC0DEBD45D5124A41C04D6665CBE82F4DC0F532FAF4124A41C095BF4385E82F4DC08B6C38FA124A41C0AE610D55DA2F4DC0F51DF6ED1A4A41C0E642B488DE2F4DC035B57104204A41C0D53A0D72DE2F4DC0EC164811204A41C04AB7052904304DC0BD9828FA4E4A41C05F7236AC25304DC051140FD83B4A41C0B2C85E589E304DC0E3B09095424A41C0621677D59F304DC0E75C82BD414A41C00C49A503F4304DC04E7F2029124A41C0C7CABB4700314DC081A53FE10A4A41C048801FE30D314DC0B9E673FA054A41C0722AF1470F314DC08D8A44AB054A41C0C43DC79D18314DC00C5F5E9B034A41C06F0660C422314DC01D497E30024A41C051CC1A862D314DC0464752C2014A41C05BAA2AC733314DC0B9F0A23E024A41C0F131346B49314DC09F50C2EC034A41C0085066DF52314DC06D878F2B044A41C0AEABE33B54314DC085723908044A41C0D49551815E314DC01FD699F9024A41C006E71AFA60314DC01FFCFFF9024A41C076D27BE067314DC0852A0FD6024A41C0363BD2766C314DC0BB1E99BE024A41C0D870F5F377314DC0B6B008B5004A41C0BF11E00D7A314DC09033F00B004A41C05E49E10F7E314DC07C85DAC8FE4941C03FB28A4E81314DC01F1327A3FD4941C0258E1F0A92314DC010CB4406FF4941C08208BF829B314DC04890C8BBFF4941C0087E4101A1314DC08F380425004A41C0151CB517A6314DC063A02169004A41C094CCF0D0E8314DC02DD8B447044A41C0CC352369F8314DC0916EEF731B4A41C0D11DA36A21324DC087342D60584A41C0FBCDB67E1C324DC012E704EB594A41C0A9FF20AC15324DC05B06425C5C4A41C0499E7D930C324DC0EC6EEA3D614A41C019AE8B9BFA314DC07C0159D26A4A41C0EFEB16DFED314DC01F8EC004714A41C01E8BD194D7314DC0112B000A7D4A41C0C6CA563FC8314DC032ABF56D854A41C016FC688CB3314DC01638FAE8904A41C0D08DC671A6314DC034029190994A41C0555EE131A4314DC0CAB6E2629B4A41C007F5B6F5B1314DC0C75F3957AF4A41C0CD8D6CC1D7314DC05DCD7D209E4A41C0E00B63ADF5314DC0AD4F7065CB4A41C07D42CACCFE314DC04B6E4D17C74A41C03A8E189B5A324DC0FB241066F44A41C08CEBAD69AB324DC02D1A661E554B41C0C40CF784D8324DC0D8A7205A314B41C00C97AD53DA324DC0DE7761BA2F4B41C09DACA5B330334DC0A5F0C611E24A41C02FB6D5DF44334DC0A522DCEECF4A41C0C5CA1FA81B334DC07986BA21974A41C0CF872A8C1E334DC07A7A5589964A41C0E482AA7B1A334DC017D017BF904A41C023B0023DF5324DC07C6ED3C9544A41C0D942EC97C8324DC06007444B164A41C0EE4CA477C2324DC00CC71B820C4A41C089E3D82AC5324DC075AD64BA0A4A41C046E608BACA324DC0C16A020F074A41C0DA9632ACEB324DC03FBCF350F14941C011CE182FEE324DC0EA6DF6A8EF4941C04283F2BA04334DC01583ABC2E04941C097AB1EA705334DC0FAC77A44E04941C0D7007AF213334DC06251299DD84941C09E5FED142F334DC07B23EE77CB4941C0127A364031334DC05102F46ACA4941C0D4AD04DA43334DC0942F527ABF4941C01C3217BD48334DC04225C641BC4941C0537687B458334DC0D8FDAEBDB14941C0A152775569334DC003963F01A44941C02924C6BC78334DC0C3931B7F914941C0F137702679334DC0D1F454FF904941C0625FAE2482334DC02B96B331864941C071E7DDFB88334DC0AC98AD1E7E4941C0935BD1138A334DC0982A934F7D4941C0C8D55F5E7D334DC059E2B5C1704941C0FDD779F076334DC0432C0C346A4941C0EFA9E10C76334DC06D247B4C694941C0D608EBC36C334DC0C8AE353F5C4941C0508E987D46334DC07813FED2314941C0819D1A8943334DC066FF91512E4941C05582357A3F334DC016A0F897284941C08D2DA4B22F334DC0438E97C9164941C05B29B0F02B334DC010F37024114941C0AC4F1DF429334DC02E2EF8B70E4941C08246F00229334DC012A017F6094941C0D9F9C59928334DC0086655E2074941C0C816171428334DC01706ADF1044941C05BF1F13E28334DC0FC67ADD9FD4841C0B893E2FE28334DC05F80F6D8FB4841C06E2920CB2B334DC00D292406F54841C096D2D5CE30334DC01B31233EEC4841C09644B42836334DC060294793E24841C0","RECOLETA",15655.5532578,2449809.67344,7501,3429,4072,2,45
21,"0106000020E61000000100000001030000000100000028000000596A32C362314DC03B673222D94A41C04823F11457314DC08B2BD64EE74A41C089CF991E51314DC08498EB92EF4A41C0E9D79C704A314DC00C94215FFC4A41C0B4BEAF9F46314DC0732B1643034B41C03D47697741314DC0795411FB0D4B41C04308A72E40314DC0E3ADDBA5104B41C0D9B9F61138314DC0D8DE72FD204B41C04101E2272C314DC0715B8A40294B41C05C26CAB926314DC0A1A8C6182C4B41C02A608B0120314DC0843BBD1F314B41C02546AA041F314DC0169341E7314B41C0A4B13FF11C314DC0D775B38A334B41C07B7985A121314DC06FF5E8F8384B41C04BC492CA23314DC0D2F022793B4B41C0DB438B9366314DC0A5326A607E4B41C035A3151786314DC0FB862E389E4B41C0BE75B36186314DC066B51B839E4B41C0EFF0CF00A8314DC0FBF3FCE9BA4B41C08599857CC8314DC0470E4C72A04B41C00CD636DBE9314DC0269DD193854B41C008BEEBC029324DC0469F6118BF4B41C0B6EB3ACC29324DC09364500FBF4B41C0E465B82032324DC0ECF33A2EB84B41C077F8C0BF8C324DC0D9E672076E4B41C0CC6BBC32A4324DC03AD16FD65A4B41C08CEBAD69AB324DC02D1A661E554B41C03A8E189B5A324DC0FB241066F44A41C07D42CACCFE314DC04B6E4D17C74A41C0E00B63ADF5314DC0AD4F7065CB4A41C0CD8D6CC1D7314DC05DCD7D209E4A41C007F5B6F5B1314DC0C75F3957AF4A41C0555EE131A4314DC0CAB6E2629B4A41C06982E7019B314DC0279F72D0A24A41C0759C0DAB89314DC0AC1B4A16B04A41C0CEB7FF7787314DC0B65B0FC5B14A41C07C3339BE7C314DC087202B98BC4A41C0B32F1C4D79314DC087E1CC65C04A41C09952CBF66D314DC06DC6BCEECC4A41C0596A32C362314DC03B673222D94A41C0","RECOLETA",3384.37365093,636595.66411,14997,6614,8383,2,45
22,"0106000020E61000000100000001030000000100000012000000828DBC107E344DC00C131BC5664B41C081096BCE7D344DC0AAF92877664B41C020ABE32D7D344DC078C6AC92654B41C0528DDB9F2D344DC03C954F19F44A41C069C738D704344DC0959187EABA4A41C073C9C737FD334DC0EA76E8D7AE4A41C02E836420FD334DC0E9B0E5D7AE4A41C01CB0B605E3334DC0DA1819A2AE4A41C0FAB109B172334DC06E201DBBAD4A41C04D91B67A5A334DC09DEBBBCEBC4A41C0D2DEB2F844334DC030E3E610D04A41C02FB6D5DF44334DC0A522DCEECF4A41C09DACA5B330334DC0A5F0C611E24A41C0F6EE173076334DC0F4690A6A144B41C0D7744498E2334DC01A5D902A634B41C08DB52F4A37344DC09685D07EA14B41C0C14A60F845344DC0AB987F18934B41C0828DBC107E344DC00C131BC5664B41C0","RECOLETA",2626.1530186,380920.131596,17433,7550,9883,2,45
23,"0106000020E610000001000000010300000001000000100000008DB52F4A37344DC09685D07EA14B41C0D7744498E2334DC01A5D902A634B41C0F6EE173076334DC0F4690A6A144B41C09DACA5B330334DC0A5F0C611E24A41C00C97AD53DA324DC0DE7761BA2F4B41C0142362902E334DC0F2A54C51694B41C01357D2523F334DC0747AD0408D4B41C0AEF82AFD56334DC0CC57C8FEBA4B41C08B3AB26480334DC0C01B2079164C41C0D5BD1E9180334DC0C9E537F8164C41C02396BEE2A8334DC0D58F9EE00B4C41C0F7214646DA334DC09090F266F34B41C07769110FEC334DC013F333B6E44B41C0FA5AC09612344DC081274184C64B41C0C1FD162936344DC0A889509AA24B41C08DB52F4A37344DC09685D07EA14B41C0","RECOLETA",2935.71511214,443647.969498,20922,9026,11896,2,45
24,"0106000020E61000000100000001030000000100000012000000D5BD1E9180334DC0C9E537F8164C41C08B3AB26480334DC0C01B2079164C41C0AEF82AFD56334DC0CC57C8FEBA4B41C01357D2523F334DC0747AD0408D4B41C0142362902E334DC0F2A54C51694B41C00C97AD53DA324DC0DE7761BA2F4B41C0C40CF784D8324DC0D8A7205A314B41C08CEBAD69AB324DC02D1A661E554B41C0CC6BBC32A4324DC03AD16FD65A4B41C077F8C0BF8C324DC0D9E672076E4B41C0E79133D6C6324DC0828F96C5A94B41C0CBBF7A9FD5324DC06ECEEC41CB4B41C0EB4C1468E4324DC0219DFFBEEC4B41C0507D5829F5324DC0C117E166164C41C0ADBE98A702334DC0982E3BBE344C41C07579E67A29334DC03030161C2E4C41C02390D0F552334DC05000EE83234C41C0D5BD1E9180334DC0C9E537F8164C41C0","RECOLETA",2366.07167057,297623.816856,13832,5954,7878,2,45
25,"0106000020E61000000100000001030000000100000011000000ADBE98A702334DC0982E3BBE344C41C0507D5829F5324DC0C117E166164C41C0EB4C1468E4324DC0219DFFBEEC4B41C0CBBF7A9FD5324DC06ECEEC41CB4B41C0E79133D6C6324DC0828F96C5A94B41C077F8C0BF8C324DC0D9E672076E4B41C0E465B82032324DC0ECF33A2EB84B41C0B6EB3ACC29324DC09364500FBF4B41C0EFF164FA48324DC0A387A21CDC4B41C0B978837350324DC0AF8A887C024C41C032E4557B58324DC011FEA2CC444C41C0A653919558324DC0A3DB74A3454C41C0ABBA4A3376324DC0B5C4142F444C41C077B51077AB324DC08F55EE90414C41C060CE6E39B3324DC06868D906414C41C08019F57ED8324DC0F92189F23B4C41C0ADBE98A702334DC0982E3BBE344C41C0","RECOLETA",2120.90956311,261765.321077,13367,5766,7601,2,45
26,"0106000020E61000000100000001030000000100000016000000EFF0CF00A8314DC0FBF3FCE9BA4B41C07DA97951A8314DC044251C2EBB4B41C07465CE03A7314DC0CFA9F941BC4B41C0983BB7A69B314DC073C83CEAE14B41C05B35931F93314DC06F86A8F11C4C41C06DE438E28D314DC0363C5E34414C41C0740505018B314DC0CCCD003D6C4C41C06A3CAD2E8B314DC0E0A1CF04714C41C0D2AFA6E587314DC063E62145944C41C04860A6AD84314DC0381ACA93B54C41C07238DE85E2314DC0E7131BF0BA4C41C0812FBB314B324DC035EDADE1C04C41C0905345F34E324DC0CB0FEB1FA64C41C0A653919558324DC0A3DB74A3454C41C032E4557B58324DC011FEA2CC444C41C0B978837350324DC0AF8A887C024C41C0EFF164FA48324DC0A387A21CDC4B41C0B6EB3ACC29324DC09364500FBF4B41C008BEEBC029324DC0469F6118BF4B41C00CD636DBE9314DC0269DD193854B41C08599857CC8314DC0470E4C72A04B41C0EFF0CF00A8314DC0FBF3FCE9BA4B41C0","RECOLETA",2847.83385028,491630.31989,18623,8314,10309,2,45
27,"0106000020E6100000010000000103000000010000001400000027DE7C8A0B334DC0D89BFE82C44C41C039DAFE3F57334DC0F1004F1EBC4C41C0073529DC74334DC0D0632D72B84C41C0413813E9AC334DC0AB2CD5329A4C41C07356FCF4AD334DC0BF0A86A5994C41C0D5BD1E9180334DC0C9E537F8164C41C02390D0F552334DC05000EE83234C41C07579E67A29334DC03030161C2E4C41C0ADBE98A702334DC0982E3BBE344C41C08019F57ED8324DC0F92189F23B4C41C060CE6E39B3324DC06868D906414C41C077B51077AB324DC08F55EE90414C41C0ABBA4A3376324DC0B5C4142F444C41C0A653919558324DC0A3DB74A3454C41C0905345F34E324DC0CB0FEB1FA64C41C0812FBB314B324DC035EDADE1C04C41C0D1BEAC7E4B324DC0A6A442E6C04C41C0E8D6A130D7324DC0A74F8DBFC34C41C0487E803F09334DC0BC107DC4C44C41C027DE7C8A0B334DC0D89BFE82C44C41C0","RECOLETA",2753.99116317,432441.579538,14044,6303,7741,2,45
28,"0106000020E610000001000000010300000001000000120000007356FCF4AD334DC0BF0A86A5994C41C07B04C048AE334DC0DCAFB079994C41C0F7777DE2C6334DC0277C13858C4C41C097870C6E0C344DC08A9038B38C4C41C02067911885344DC0B296AA3F8E4C41C0035B3B49B9344DC033033E918B4C41C0BAE97AC9B9344DC08C73008C8B4C41C0D7728B18AF344DC025C8D3E4514C41C0BEF641595E344DC08D5C619DBE4B41C04F4314A43E344DC0E8718DE8A64B41C08DB52F4A37344DC09685D07EA14B41C0C1FD162936344DC0A889509AA24B41C0FA5AC09612344DC081274184C64B41C07769110FEC334DC013F333B6E44B41C0F7214646DA334DC09090F266F34B41C02396BEE2A8334DC0D58F9EE00B4C41C0D5BD1E9180334DC0C9E537F8164C41C07356FCF4AD334DC0BF0A86A5994C41C0","RECOLETA",2776.6810327,448431.690411,18854,8305,10549,2,45
29,"0106000020E6100000010000000103000000010000000E000000BAE97AC9B9344DC08C73008C8B4C41C004B4AA2E12354DC0B1DC0908884C41C0CF71B0893F354DC0664D8285864C41C067FBE3CE2F354DC03249E311614C41C0511FBD340B354DC07D16BDBB0A4C41C066B6A1BD0A354DC0E82ACA320A4C41C0CA503C2DC8344DC07AC56EF9BD4B41C0828DBC107E344DC00C131BC5664B41C0C14A60F845344DC0AB987F18934B41C08DB52F4A37344DC09685D07EA14B41C04F4314A43E344DC0E8718DE8A64B41C0BEF641595E344DC08D5C619DBE4B41C0D7728B18AF344DC025C8D3E4514C41C0BAE97AC9B9344DC08C73008C8B4C41C0","RECOLETA",2673.26420878,303957.316593,12569,5558,7011,2,45
40,"0106000020E610000001000000010300000001000000120000000DEFA5B308344DC07C1C1FF48C5041C08F0964A709344DC0CA87740F8D5041C0629E56A245344DC00CCC11E8935041C0F5A9292DB5344DC0977ACC76AF5041C0D8A52A78B7344DC05A49F9C3895041C0FCB2F407BA344DC0DB1EF89E545041C0B0185BAFBE344DC0E98FF577035041C04E12494CBF344DC09DB878CBFE4F41C02E6619A0C7344DC063B20987BF4F41C0B8DC60B4BD344DC034636A84BD4F41C0DDAC165BC8344DC02D8D2889994F41C06D5AEBCECA344DC078D26A89994F41C05E250E4ECE344DC0A58BF027714F41C0C4501A8195344DC0F8FDF82F674F41C0A637482D32344DC03CCF9DEE524F41C0C36AD93424344DC0FE449615A14F41C096EBD70C15344DC0B2A609A91F5041C00DEFA5B308344DC07C1C1FF48C5041C0","SAN CRISTOBAL",3128.58895559,495956.041275,8356,4018,4338,3,13
41,"0106000020E61000000100000001030000000100000014000000F3D007BFCC324DC0F80EEF64655041C0B4990D6105334DC0615DCAD36F5041C0A477EA4657334DC038DE1C11795041C0FC07B38CEA334DC016200D93895041C00DEFA5B308344DC07C1C1FF48C5041C096EBD70C15344DC0B2A609A91F5041C0C36AD93424344DC0FE449615A14F41C0A637482D32344DC03CCF9DEE524F41C0900AD88E31344DC042A107CE524F41C059400B0FA7334DC0FE0C400D364F41C0ED8224FAA5334DC04C8C32FA354F41C077EAF81C53334DC069D7DC70304F41C030E0DE5C34334DC0ED7F35622E4F41C0CBAF3BEC10334DC02BBCBC7E2C4F41C0BD3C225C0E334DC062EE0B3A4D4F41C0B0125FDBFF324DC0E7F017107C4F41C0A04C72BDF0324DC0AC4181DCB64F41C02EC203ACE7324DC07E5B4A40D64F41C0948B466AE0324DC0E51588A6F34F41C0F3D007BFCC324DC0F80EEF64655041C0","SAN CRISTOBAL",3865.34062421,936340.638942,17901,8787,9114,3,13
42,"0106000020E6100000010000000103000000010000001300000000D42D4123324DC001FD00481F4F41C0D75A36651E324DC0ED83E0BA8F4F41C010F7F27F1C324DC088F253F7B54F41C0CB5690801A324DC0A1F11739DE4F41C0EEF0F1F011324DC0F8C2B698495041C0A4BC15EA11324DC0C54926EB495041C0059E62C232324DC0E203C0254A5041C067124E6ECC324DC06FCA8556655041C0F3D007BFCC324DC0F80EEF64655041C0948B466AE0324DC0E51588A6F34F41C02EC203ACE7324DC07E5B4A40D64F41C0A04C72BDF0324DC0AC4181DCB64F41C0B0125FDBFF324DC0E7F017107C4F41C0BD3C225C0E334DC062EE0B3A4D4F41C0CBAF3BEC10334DC02BBCBC7E2C4F41C027AEDCFCE1324DC0A8A492FE294F41C016A92D91E0324DC0535079EB294F41C0B2996233AF324DC0362B3825274F41C000D42D4123324DC001FD00481F4F41C0","SAN CRISTOBAL",3289.60184429,611654.593975,16848,8148,8700,3,13
30,"0106000020E6100000010000000103000000010000000E0000005624464DCF344DC0579E0442014D41C0085D3183C0344DC02E799604B64C41C0035B3B49B9344DC033033E918B4C41C02067911885344DC0B296AA3F8E4C41C097870C6E0C344DC08A9038B38C4C41C0F7777DE2C6334DC0277C13858C4C41C07B04C048AE334DC0DCAFB079994C41C052675B52C7334DC0DA9EDA7DEC4C41C07A7AB938D0334DC0BC8927FF094D41C0B9E8251BDC334DC09ABAB50B3A4D41C056DF97F624344DC0847AECAA2F4D41C01850A0AF47344DC08BA249FE2D4D41C08B0CDB9572344DC0FE850C81204D41C05624464DCF344DC0579E0442014D41C0","BALVANERA",2435.44988785,372621.674279,11737,5594,6143,3,25
31,"0106000020E61000000100000001030000000100000013000000902ED101E6334DC06050BC11624D41C0B9E8251BDC334DC09ABAB50B3A4D41C07A7AB938D0334DC0BC8927FF094D41C052675B52C7334DC0DA9EDA7DEC4C41C07B04C048AE334DC0DCAFB079994C41C07356FCF4AD334DC0BF0A86A5994C41C0413813E9AC334DC0AB2CD5329A4C41C0073529DC74334DC0D0632D72B84C41C039DAFE3F57334DC0F1004F1EBC4C41C027DE7C8A0B334DC0D89BFE82C44C41C0487E803F09334DC0BC107DC4C44C41C0E8D6A130D7324DC0A74F8DBFC34C41C0FDD0537BCE324DC0CA02D2CF374D41C0FF85EB68C9324DC016631EF4604D41C09A36EC55C9324DC08CCE3192614D41C012294D2EE0324DC072ADD92B624D41C024FCE9BE4B334DC007252E2B664D41C0717E1304A9334DC0EEFC5E77684D41C0902ED101E6334DC06050BC11624D41C0","BALVANERA",2667.62871843,415581.460014,14387,6840,7547,3,25
32,"0106000020E61000000100000001030000000100000011000000D1BEAC7E4B324DC0A6A442E6C04C41C0B95BE3EC39324DC06A46F366344D41C04EC4C5C536324DC0966C17B55D4D41C071FD34C136324DC0505A16F05D4D41C00D6B91B833324DC0E00345BD854D41C0E63865C92B324DC01F185823F94D41C03F37E39659324DC064459DE7FC4D41C0BB441175B3324DC03A08C125034E41C021C6BA85B9324DC0DD1BD79B034E41C0BEC10788B9324DC01B82B970034E41C03F1C3C43BF324DC014CF14E2B64D41C02C3986B3C3324DC0C9920663914D41C09A36EC55C9324DC08CCE3192614D41C0FF85EB68C9324DC016631EF4604D41C0FDD0537BCE324DC0CA02D2CF374D41C0E8D6A130D7324DC0A74F8DBFC34C41C0D1BEAC7E4B324DC0A6A442E6C04C41C0","BALVANERA",2937.03524157,433560.755117,13128,6447,6681,3,25
33,"0106000020E61000000100000001030000000100000017000000AA4AEEC410354DC0A38FE89EFF4D41C0F3F06AD713354DC0E649D0A8D94D41C05F719E560B354DC05D92E353D54D41C050E727CB00354DC0959CC1F3CF4D41C02F52F4F9FB344DC0DE940046BE4D41C0653B4175EA344DC03BF6522F744D41C065A16545E3344DC01B327FC3544D41C0B65AC757DC344DC0D8F1A67E364D41C037E4EE81CF344DC0B4D1074D024D41C05624464DCF344DC0579E0442014D41C08B0CDB9572344DC0FE850C81204D41C01850A0AF47344DC08BA249FE2D4D41C056DF97F624344DC0847AECAA2F4D41C0B9E8251BDC334DC09ABAB50B3A4D41C0902ED101E6334DC06050BC11624D41C04212A61DE6334DC097693583624D41C0B9B61B03EF334DC0E366E841864D41C011960CDAF5334DC00D919A76A54D41C01FE4F200FC334DC0E448DD5EC64D41C0A9EF8797F9334DC0F1C95EF2EE4D41C03469BF2654344DC009D77E87F74D41C0A678B87D84344DC0003C0DADF84D41C0AA4AEEC410354DC0A38FE89EFF4D41C0","BALVANERA",3022.72550166,526528.617245,10331,5115,5216,3,25
34,"0106000020E61000000100000001030000000100000013000000087EC3E4F6334DC00CAC9656184E41C0DD07F292F9334DC04B1AF337EF4D41C0A9EF8797F9334DC0F1C95EF2EE4D41C01FE4F200FC334DC0E448DD5EC64D41C011960CDAF5334DC00D919A76A54D41C0B9B61B03EF334DC0E366E841864D41C04212A61DE6334DC097693583624D41C0902ED101E6334DC06050BC11624D41C0717E1304A9334DC0EEFC5E77684D41C024FCE9BE4B334DC007252E2B664D41C012294D2EE0324DC072ADD92B624D41C09A36EC55C9324DC08CCE3192614D41C02C3986B3C3324DC0C9920663914D41C03F1C3C43BF324DC014CF14E2B64D41C0BEC10788B9324DC01B82B970034E41C021C6BA85B9324DC0DD1BD79B034E41C0726F291141334DC02ACAE7EA0D4E41C017012E3B42334DC0BE29B2FB0D4E41C0087EC3E4F6334DC00CAC9656184E41C0","BALVANERA",2863.31368997,496974.351017,15739,7459,8280,3,25
35,"0106000020E61000000100000001030000000100000014000000A457C6CBD6344DC06B825686C64E41C0B5E2D1CED6344DC0E975BC5CC64E41C07ECDFD77D9344DC0B1F6C61F9B4E41C0161E29AAE7344DC0A1F4E43C714E41C0461FB21C0D354DC0229613D82C4E41C0AA4AEEC410354DC0A38FE89EFF4D41C0A678B87D84344DC0003C0DADF84D41C03469BF2654344DC009D77E87F74D41C0A9EF8797F9334DC0F1C95EF2EE4D41C0DD07F292F9334DC04B1AF337EF4D41C0087EC3E4F6334DC00CAC9656184E41C04F8F1ECDF6334DC0757BA5C4194E41C0F840A769F5334DC04757D3E42F4E41C07D91BCF8F1334DC0A3475D353F4E41C03662EC06E9334DC073AF8F37654E41C082EA7AB5DE334DC0854D0FAF864E41C09403EA98D3334DC020FEA7E3AC4E41C02ECCF4C91E344DC070BE6905B64E41C0DB7473BA6E344DC0440FDE71C04E41C0A457C6CBD6344DC06B825686C64E41C0","BALVANERA",2871.01579705,494962.916385,12141,5332,6809,3,25
36,"0106000020E6100000010000000103000000010000000F000000ED8224FAA5334DC04C8C32FA354F41C059400B0FA7334DC0FE0C400D364F41C0900AD88E31344DC042A107CE524F41C0A637482D32344DC03CCF9DEE524F41C0C4501A8195344DC0F8FDF82F674F41C05E250E4ECE344DC0A58BF027714F41C0074B676AD1344DC0CB027956484F41C0056F1D54D4344DC0C5AD7892EE4E41C0A457C6CBD6344DC06B825686C64E41C0DB7473BA6E344DC0440FDE71C04E41C02ECCF4C91E344DC070BE6905B64E41C09403EA98D3334DC020FEA7E3AC4E41C07DF2494AC6334DC03A70F3A2DA4E41C0C1858BE9B9334DC0DD93CE5FFE4E41C0ED8224FAA5334DC04C8C32FA354F41C0","BALVANERA",2644.22047685,411907.175655,8632,4289,4343,3,25
37,"0106000020E6100000010000000103000000010000001200000077EAF81C53334DC069D7DC70304F41C0ED8224FAA5334DC04C8C32FA354F41C0C1858BE9B9334DC0DD93CE5FFE4E41C07DF2494AC6334DC03A70F3A2DA4E41C09403EA98D3334DC020FEA7E3AC4E41C082EA7AB5DE334DC0854D0FAF864E41C03662EC06E9334DC073AF8F37654E41C07D91BCF8F1334DC0A3475D353F4E41C0F840A769F5334DC04757D3E42F4E41C04F8F1ECDF6334DC0757BA5C4194E41C0087EC3E4F6334DC00CAC9656184E41C017012E3B42334DC0BE29B2FB0D4E41C0DE1BCBB93C334DC0071921E1504E41C02D16AB7D3A334DC07CBC7E3A7D4E41C0B2B5ADD662334DC0BD7F6CAA7F4E41C04F76C8595C334DC0A6689AA9C84E41C0B3BAD01B59334DC00611E06FEC4E41C077EAF81C53334DC069D7DC70304F41C0","BALVANERA",2825.2405043,362664.091054,11589,5614,5975,3,25
38,"0106000020E61000000100000001030000000100000012000000B2996233AF324DC0362B3825274F41C016A92D91E0324DC0535079EB294F41C027AEDCFCE1324DC0A8A492FE294F41C0CBAF3BEC10334DC02BBCBC7E2C4F41C030E0DE5C34334DC0ED7F35622E4F41C077EAF81C53334DC069D7DC70304F41C0B3BAD01B59334DC00611E06FEC4E41C04F76C8595C334DC0A6689AA9C84E41C0B2B5ADD662334DC0BD7F6CAA7F4E41C02D16AB7D3A334DC07CBC7E3A7D4E41C0DE1BCBB93C334DC0071921E1504E41C017012E3B42334DC0BE29B2FB0D4E41C0726F291141334DC02ACAE7EA0D4E41C021C6BA85B9324DC0DD1BD79B034E41C086DC40BFB4324DC069FD606F4E4E41C07BFB80AFB4324DC047E9EA839B4E41C0242AE90FB3324DC0DFE5BD7DD94E41C0B2996233AF324DC0362B3825274F41C0","BALVANERA",2922.27584592,428339.600787,13108,6414,6694,3,25
39,"0106000020E6100000010000000103000000010000000E000000E63865C92B324DC01F185823F94D41C0BAF721832B324DC07728DD1EFD4D41C0338FD44525324DC0DE29331E6C4E41C044E32ABC23324DC0448E0A58914E41C01114273121324DC0699272F5CE4E41C000D42D4123324DC001FD00481F4F41C0B2996233AF324DC0362B3825274F41C0242AE90FB3324DC0DFE5BD7DD94E41C07BFB80AFB4324DC047E9EA839B4E41C086DC40BFB4324DC069FD606F4E4E41C021C6BA85B9324DC0DD1BD79B034E41C0BB441175B3324DC03A08C125034E41C03F37E39659324DC064459DE7FC4D41C0E63865C92B324DC01F185823F94D41C0","BALVANERA",2774.98110688,397924.140041,14296,6835,7461,3,25
43,"0106000020E61000000100000001030000000100000013000000A4BC15EA11324DC0C54926EB495041C0E5BD56540E324DC07B76182F695041C06D80C240F7314DC0B02F9B1A2B5141C03B54773EF7314DC0D19CCD322B5141C06E5BF9EAAD324DC0F041249D535141C00F474221DF324DC05B87E4065D5141C0992BD5236C334DC008B12422765141C076E61730AF334DC04769CE7B825141C0662111D4C7334DC099A5D70D0D5141C0ECBAA5AFCD334DC09868BC4EEB5041C0E7C2B6B8D4334DC05F2B0E47B65041C0D51B41BAD4334DC0CC58E498AD5041C0FC07B38CEA334DC016200D93895041C0A477EA4657334DC038DE1C11795041C0B4990D6105334DC0615DCAD36F5041C0F3D007BFCC324DC0F80EEF64655041C067124E6ECC324DC06FCA8556655041C0059E62C232324DC0E203C0254A5041C0A4BC15EA11324DC0C54926EB495041C0","PARQUE PATRICIOS",4240.11853461,1048153.78007,12645,6221,6424,4,17
44,"0106000020E6100000010000000103000000010000001400000076E61730AF334DC04769CE7B825141C0C8AED961E3334DC0FCE989188C5141C033BFB0F2A3344DC0D2170D38AD5141C0C354BBBC8A344DC0965D9CB15D5141C08204DBEA8A344DC0927F841B4F5141C08FA4CDEF97344DC0BFBD6FED365141C0C023B7029B344DC0A6D1F91D2F5141C0BBD2B2A7AB344DC0D8E01AD6045141C09CC040C0AC344DC02D8A5F4E015141C037C85E29B5344DC055F75C9DAF5041C0F5A9292DB5344DC0977ACC76AF5041C0629E56A245344DC00CCC11E8935041C08F0964A709344DC0CA87740F8D5041C00DEFA5B308344DC07C1C1FF48C5041C0FC07B38CEA334DC016200D93895041C0D51B41BAD4334DC0CC58E498AD5041C0E7C2B6B8D4334DC05F2B0E47B65041C0ECBAA5AFCD334DC09868BC4EEB5041C0662111D4C7334DC099A5D70D0D5141C076E61730AF334DC04769CE7B825141C0","PARQUE PATRICIOS",3034.38018983,536442.185014,9017,4308,4709,4,17
45,"0106000020E6100000010000000103000000010000000F0000004A256AE765334DC0E5D6D35ECC5241C038A1B3198D334DC00C387DDED25241C0723D6359D6334DC095344C02DF5241C09020EEC0BF344DC06BEF9ACD045341C097DEDE0BC0344DC0E27DE486035341C0F7EF760ECE344DC0DC8E95AEC65241C023CE74F6E7344DC092B9B9E15D5241C08ACEDAA0EB344DC0534C629E5C5241C04BDF2486B6344DC001904C1CDF5141C033BFB0F2A3344DC0D2170D38AD5141C0C8AED961E3334DC0FCE989188C5141C076E61730AF334DC04769CE7B825141C07AC7820DA7334DC03540E53EA95141C079E985EB7C334DC0FEA0AF52635241C04A256AE765334DC0E5D6D35ECC5241C0","PARQUE PATRICIOS",4035.94803967,1041288.67692,6626,3338,3288,4,17
46,"0106000020E6100000010000000103000000010000001A0000003B54773EF7314DC0D19CCD322B5141C0537AA3E5F2314DC03B0423615C5141C089BD7E62E8314DC09B5547B4E55141C02DFDA86CE7314DC0104E2D47F25141C021D419241C324DC0DC819B4C065241C0928B666B19324DC0ACC8D3DE2F5241C01A3A48B23F334DC0243965F6AC5241C029411C4E43334DC090568A45AD5241C0E1280C873E334DC0B9262869BA5241C0641651193E334DC05AD3C4E1BB5241C0451B53CC41334DC0340BA274BD5241C06CF1F27C41334DC08A787719BE5241C085984A7F44334DC045F12FE1BF5241C0FA91D54B48334DC0C3BD4521C25241C0C336BAB349334DC0BAE3FCF5C25241C0FF8993B656334DC04B5AAA15C85241C0614DD2B665334DC0DA3AC0C9C95241C0B00EA7F664334DC04BBE5E37CC5241C04A256AE765334DC0E5D6D35ECC5241C079E985EB7C334DC0FEA0AF52635241C07AC7820DA7334DC03540E53EA95141C076E61730AF334DC04769CE7B825141C0992BD5236C334DC008B12422765141C00F474221DF324DC05B87E4065D5141C06E5BF9EAAD324DC0F041249D535141C03B54773EF7314DC0D19CCD322B5141C0","PARQUE PATRICIOS",4504.24255659,1117390.83346,6122,3165,2957,4,17
47,"0106000020E6100000010000000103000000010000006E000000076EBFFA3A334DC0FC44A168975441C01FEF33C240334DC0E89B68BE945441C064215DEF40334DC0CF009F9F8D5441C066742A9C44334DC0F96557EB8C5441C0D21B447B47334DC0145648298A5441C090552E3F49334DC0EB6030CD875441C03EF4CE9A4A334DC0399336FC855441C015ED83F74B334DC0A47CC16D825441C0B58EC0844E334DC092C8015A815441C0F59C6D6D58334DC00C319B426D5441C0875008DF5A334DC047036E966A5441C0CFA1038975334DC0DC27E61B2B5441C005B41EE58C334DC00DD10B30F45341C01F04AA429D334DC0BC447EDEC35341C04988A7C6A2334DC0F4603D86B15341C0CA7124B7B3334DC010BD4232795341C03ECC8E2DB5334DC05E6E0F11755341C0751B6561B6334DC0F8FEA6AA715341C09F2DEF73C4334DC0D7F597874E5341C07B6F0010C7334DC04A3304464A5341C09BDC220ED4334DC0AE80C1E7335341C065929335D8334DC09EEA4A3E2C5341C04E4DE48FCA334DC0DFDE9FB7205341C04263182DC7334DC0E7DD3DB51D5341C09F979BD6C5334DC0DBD804851C5341C03D6E62D6C3334DC074F175BD1A5341C0C76633F9A4334DC028EF5AFFF15241C06D3A6C849B334DC09F20AFAAE55241C038A1B3198D334DC00C387DDED25241C04A256AE765334DC0E5D6D35ECC5241C0B00EA7F664334DC04BBE5E37CC5241C0614DD2B665334DC0DA3AC0C9C95241C0FF8993B656334DC04B5AAA15C85241C0C336BAB349334DC0BAE3FCF5C25241C0FA91D54B48334DC0C3BD4521C25241C085984A7F44334DC045F12FE1BF5241C06CF1F27C41334DC08A787719BE5241C0451B53CC41334DC0340BA274BD5241C0641651193E334DC05AD3C4E1BB5241C0E1280C873E334DC0B9262869BA5241C029411C4E43334DC090568A45AD5241C01A3A48B23F334DC0243965F6AC5241C0928B666B19324DC0ACC8D3DE2F5241C021D419241C324DC0DC819B4C065241C02DFDA86CE7314DC0104E2D47F25141C08E26B2FED5314DC0FB162DC8CA5241C039279C20D5314DC099FB6C8BD55241C00161DC17B3314DC00FCFD4B8875441C06D12FC22B5314DC0498A9CEF875441C0CC40F88CBC314DC099B0FA6F8E5441C00E14D35EC2314DC0CC847B59905441C07E1E4798C8314DC03241B586915441C0474D605CCD314DC0B2343E74945441C0A50389ACD3314DC079E20009925441C0705DFE85DA314DC04E027461935441C02F61E8AFDD314DC0B1B1EE74975441C011141B92E5314DC0861CC7F6995441C0EAF5CCAAED314DC05CFFD9DF9B5441C01C619F2CF6314DC08FB916E69C5441C0F1479650FC314DC08AB9ADA59F5441C00A58B27400324DC091DDF767A25441C0375699E311324DC079548538AB5441C0C1F895A216324DC050ABBF8EAD5441C0CBEC8BC917324DC0694A729EAE5441C0F5C1C6F719324DC0AD709CA2B05441C0A2CBEAF71E324DC037793E5BB55441C062E9E4C023324DC08AC06D59BA5441C010990A3B27324DC0FB3E319CBD5441C05F168FAB2B324DC0DCF943C7BF5441C05F40A60731324DC0B10636D4C15441C08E2DD61A36324DC0770E2EE4C55441C057437AB93E324DC01AC42B12CA5441C0B0B7851045324DC0247E82B9CA5441C05A81302E4E324DC09DA6557ECA5441C0DF4EDF8658324DC0E01D8FEDCC5441C0FA72A6735E324DC07A80C4BECC5441C09E78C6E964324DC0681D16CECC5441C0F0535B6769324DC009624D66CA5441C0EF780C1A71324DC000C0725FC95441C042FD7C9A78324DC005CFD5D6C65441C00CED02D580324DC09E67F820C65441C09FD4CB9987324DC017262386C55441C0E9516FE48F324DC01093498AC35441C0564719FB94324DC0E431FFE7C15441C05F9ACE9798324DC004E2F9DEBE5441C00D0B26749D324DC0ED301287BA5441C0D9FBAF37A5324DC0D3733A3AB85441C0879C0873AC324DC081CFB869B75441C07D467459B5324DC08CC078C3B75441C005715553B6324DC0B6D3D99ABB5441C02FA6B3AABD324DC0BC2C9A09BE5441C044C0D5F7C6324DC0C144503EBE5441C01A8B9F83D0324DC04FE7D273BE5441C007263D8DDA324DC09889AE3BBC5441C0F53CF2EAE0324DC0D9ADD3CEB95441C0ADB71498E3324DC0C5AA2EF1B75441C0331E4D0BE7324DC0B5A9B598B45441C0EC207469EA324DC0FE12DC1EAD5441C03D2F7395EA324DC071DEFD1FAC5441C0CC3A5FEFEA324DC09902BE13A45441C0D8E8A15D1A334DC083D59482975441C0AADAFA5A1C334DC0B51E55CA985441C0B3B94CAB1F334DC0E8F245129A5441C02FBA4F4F24334DC0DB9088889B5441C07B4C9C4928334DC02219A3449C5441C047C7EF972D334DC08C01C3899B5441C02787A23E30334DC0BD8A1C8A9B5441C059EABA9231334DC0A0D2DBB6995441C0F9B3858D35334DC04C8FF5E3975441C0076EBFFA3A334DC0FC44A168975441C0","BARRACAS",6758.32928522,2495450.5872,10233,5294,4939,4,30
48,"0106000020E610000001000000010300000001000000230000002DFDA86CE7314DC0104E2D47F25141C089BD7E62E8314DC09B5547B4E55141C0537AA3E5F2314DC03B0423615C5141C03B54773EF7314DC0D19CCD322B5141C06D80C240F7314DC0B02F9B1A2B5141C0811CB57BAD314DC0B98AECB5195141C004281A7C24314DC0B0CA09D0F15041C0436E1E3013314DC0C51FFE42EC5041C0B0350AFFF9304DC0AF85989FDD5041C0403ADD50CF304DC0D3CB064CC15041C0449F14E4CC304DC0A7186B5E085141C0E6707498A8304DC0F4BD831A075141C07CF7641CA7304DC0FD73BFF6F95041C0929535EF97304DC0957E6A06F15041C09FBE72EC93304DC0215EA08FEC5041C052A6EE3994304DC0A1032994EA5041C05E80E08976304DC0393D97F8B35041C0406647AA85304DC0FEA4124D8D5041C0717A49EB5F304DC075269DD0765041C0BAA779885F304DC07F41CA94765041C0126E8F1E5A304DC0DB5A5193805041C07753668144304DC0280F76BEA25041C089E9DD7423304DC05996DE7FF15041C0D103219C0C304DC0FE73015E345141C084BEE739FB2F4DC0C7EEA3538F5141C0C43F8E87FA2F4DC0F7F5A1FC925141C03E0E174FF72F4DC0730F83C4A45141C0F582645BEC2F4DC06B5F8E41E15141C0487FB1F2D32F4DC02A81E3DA625241C053C6540403304DC0576DD8296E5241C007132EE139304DC08BBFE0B57B5241C01FD89FA1CA304DC08F95ED959D5241C03C5C573C76314DC03F09F639C65241C08E26B2FED5314DC0FB162DC8CA5241C02DFDA86CE7314DC0104E2D47F25141C0","BARRACAS",6466.6734628,2072727.19266,14267,7271,6996,4,30
49,"0106000020E610000001000000010300000001000000E4020000487FB1F2D32F4DC02A81E3DA625241C00F685140C12F4DC0ED81091FC65241C0105B8781B82F4DC0A4DF542AF75241C0C3E839AFB32F4DC05AD8D4740D5341C023A4AAD89F2F4DC0195CECFE3D5341C0C18D4C39902F4DC052993BAF5E5341C0AB0F8AE7892F4DC0CAFD607A745341C0FDD5C5AC6F2F4DC03F6A0139BA5341C0356EB93DAF2F4DC04C4B69C3D65341C0AF7F9615D02F4DC0763D511F015441C07D36EDA1DC2F4DC08C31600B115441C04C282E26E12F4DC01203BAE5145441C012819F3B07304DC0F2348FEC1B5441C000F365B521304DC03FABA502165441C06F8431AF22304DC09AC0C453165441C09680953E23304DC0F305FF81165441C0F53442B123304DC0F29351BC165441C048EE75FA23304DC0D1B87CE7165441C012ABB44924304DC0B0892EF8165441C076011D8624304DC028C46AF1165441C0AF7B51CC24304DC04D374EDF165441C0144CD91A25304DC0A710C6D4165441C0988BB55225304DC066720ED4165441C04B74C38325304DC093A4F6E0165441C0C2467EA925304DC0486174FB165441C06A9A48B625304DC03B534921175441C09B46A78325304DC048DFD64A175441C0430E0E5125304DC0E10D0B66175441C0E08BD33225304DC034363E81175441C018D5AD4B25304DC06B4C3CB9175441C021CA629625304DC0C3A3D3DC175441C0DF33FAF325304DC04C7C3AE5175441C0BB06D95326304DC0C83AE8F2175441C0B4C5010C27304DC029ADD115185441C0CC22979127304DC08CDE013E185441C0DBEC84FD27304DC0CE69A061185441C03CFED55828304DC097A5856B185441C096DE15D028304DC0F3F25385185441C0633C934929304DC0E6E59BB9185441C0BA3525AA29304DC0D0402FF6185441C043AADDFA29304DC0D9098536195441C0AD9369362A304DC09386BE86195441C0173235682A304DC09A4E5EB0195441C0792A19AC2A304DC030A389DB195441C020F6D1FC2A304DC0AAC87D0A1A5441C0F83CB73D2B304DC063C338211A5441C062DB0F742B304DC0420BD92B1A5441C0C1D8A7A92B304DC07CA5F5341A5441C0440531D62B304DC056D2DB411A5441C07A9CE52128304DC0A2F6D2AB1A5441C0103FD14828304DC0194B98F21B5441C0DF2357E530304DC0BBC415561B5441C0FB2882B331304DC0E993F1151B5441C0942123C432304DC08E9805B01A5441C0EDEFD24C33304DC0A6B63E841A5441C0D65C27CA33304DC0848235751A5441C0621C0B2734304DC0A239DB601A5441C0B01835CD34304DC07BAE440C1A5441C0C7182B0E35304DC0A0201AF4195441C08BC0BE4635304DC061A167121A5441C0A89DB69335304DC039A62A2C1A5441C078B99ACE35304DC03F0B04331A5441C08CE4E60A37304DC034DA04371A5441C0EDA659C537304DC07F2988451A5441C020D6704038304DC03CC7222B1A5441C0FB7BBBB138304DC04748C8F7195441C0E54EE2E838304DC0A79635CB195441C070F9B21439304DC06A01AFA7195441C0A5501A5139304DC0F4D2B2A4195441C01732228539304DC052572CD8195441C04DC12D9439304DC0B97127101A5441C08FA190D339304DC021D8B02D1A5441C099BD091C3A304DC001D2C3301A5441C023904D6B3A304DC0A933D9331A5441C0FF09F3403B304DC01A4B762F1A5441C0758602BC3B304DC06828F0211A5441C0EEDDFBFF3B304DC09BC61A121A5441C0F9BA3B4C3C304DC0019F220F1A5441C0D45B2B903C304DC0B9186D0E1A5441C08F1830FC3C304DC04DFB2FCB195441C00113AF603D304DC09A923D71195441C0B1F385B43D304DC069B7CE53195441C0E1DE190C3E304DC0E798743F195441C0B79F32873E304DC0952E021F195441C05025B9FD3E304DC059D75C21195441C0F18326493F304DC0DEED4F50195441C0E47FDF993F304DC0459B258F195441C0DA0F8FC23F304DC09A0E01D4195441C0778878E43F304DC05052C10C1A5441C04614DCFE3F304DC0DA75DA341A5441C0C2790C4540304DC0B72DD2471A5441C084514B9440304DC0C0E1CD5D1A5441C06794C0DF40304DC0CFD2257F1A5441C0BD2FF02541304DC0B4E41F951A5441C099653DA641304DC0469D7CB61A5441C041D37D6A42304DC0AF008BC91A5441C01C6D27D142304DC020CB39D71A5441C0BB499B4143304DC046854FF61A5441C022FE959143304DC0A031F81F1B5441C0A9C51DBE43304DC0D4EFDB2C1B5441C0E28F1A5844304DC041F686341B5441C074CDE7F544304DC093FF06271B5441C077DDE46745304DC0D0F097251B5441C0F527C7C445304DC0D48C3D111B5441C06D694D1646304DC0442A020C1B5441C04C54153646304DC006A246D01A5441C00774FB3F46304DC0D06EC7771A5441C00181385846304DC0196B62281A5441C08F8E44C146304DC0BCE2F9B3195441C0A3FB3BF946304DC00546485C195441C0E674CB2247304DC0EAB0E62B195441C0EE14C53847304DC09D0D9AE8185441C08B2D194147304DC00EEA55C7185441C07BF4868648304DC0ECBFA395185441C0EC2C272B49304DC0321E1463185441C0AAE768C149304DC0C3922D44185441C06914707D4A304DC06EEDAD17185441C0675D1C0C4B304DC0C0B51F23185441C0B05E4C524B304DC05BEB9A37185441C016492E964B304DC0157E126B185441C07D9791D84B304DC0FF35499C185441C00A27331A4C304DC08277E3BF185441C0DEDDAA654C304DC08FC66DDD185441C00FBFA6B24C304DC082FF11E8185441C0558E62224D304DC02C556BEA185441C01A13B9C44D304DC00BEA86CB185441C0E5707A314E304DC0A37682A3185441C015373AA14E304DC05CECBB96185441C0DFC177ED4E304DC0D726338C185441C070732AB04F304DC02B232AD1185441C0D685C25A50304DC040E2F7E7185441C00A69D3FD50304DC05F4760ED185441C0B585746751304DC0EF52D61A195441C078DC4FCD51304DC0B1427D60195441C094839A0352304DC0DD6D2F90195441C0CA72693252304DC03BEA8898195441C0E341DC5552304DC04A6E58BB195441C004FCB56B52304DC0ADF52EE1195441C0FB10437F52304DC0D89406261A5441C0848A0B8952304DC0AE102C541A5441C0E4A2C18952304DC03CBA77781A5441C02ED9D09852304DC0D9738C9D1A5441C0832B44BC52304DC02C3B80B31A5441C00A4584E652304DC02DDA7FCC1A5441C0E3588A1A53304DC0164BD00C1B5441C07012212E53304DC070D73C3D1B5441C0DA42B84153304DC0E470825B1B5441C06098C59A53304DC0118604731B5441C0D03CB1DB53304DC085D02E821B5441C0FB339BFA53304DC03E4A3FA41B5441C04825891C54304DC01EBE59CC1B5441C003DEC74654304DC04F92A4EA1B5441C04BD27C4754304DC08C6EC8181C5441C09D8CF62C54304DC0BBCB08751C5441C0BE0F172054304DC0BD8E629F1C5441C0E1CFDC2C54304DC09EDD5AD71C5441C0A4D3193254304DC00B3547091D5441C08A645B3754304DC089BCD0291D5441C0BBDE853354304DC0913DF0571D5441C033643EF053304DC0CFF58AC21D5441C0086FBED253304DC0FA306BF11D5441C0226D61A253304DC0EB0BC8211E5441C02699806D53304DC03CC114491E5441C031BFC00353304DC0036FEE7A1E5441C0B6E361F852304DC018EB44A51E5441C0E59AE60253304DC0034546E01E5441C0982A30EF64304DC076DBE759225441C0726518CA65304DC0C7094572225441C02E517BA366304DC08AC0208C225441C09F881E0767304DC06D36F48C225441C0F3DEBD6167304DC0516B8D72225441C07BCA4E6367304DC031C86844225441C0433AA23767304DC085AE86DD215441C07C95861C67304DC073F9EB97215441C0F9F5982267304DC03D770066215441C0A8E0A24767304DC0A6803B43215441C090F5918867304DC0B9EEE834215441C0D2247BC967304DC01291453D215441C0DA47560468304DC0CE4DEA66215441C033C84D5468304DC07F4F2398215441C032EB817868304DC0A72331BA215441C0D1908ECE68304DC0E1D4D6C4215441C06C4A071469304DC09CBF3FB4215441C0A4E2BC096D304DC072E9E643225441C0358B7C516D304DC0C58A882F225441C0E81D40646E304DC012DAF14A225441C0DCDDA6876F304DC02CC85041225441C086B938E56F304DC0EE064870225441C0A7E94F3B70304DC03FC5C84C225441C0A4B8D3D670304DC0C948E44C225441C0C2163A6371304DC005A9645E225441C03543DCF771304DC0F460FCB6225441C02DF08B6D72304DC043140B0E235441C02B0D1DCB72304DC0A0CC642F235441C06295D93D73304DC0B3B75A3F235441C011046E9B73304DC0D48F7864235441C0FD2A10DD73304DC0081C8F86235441C0741FEE1774304DC07F9BF794235441C0C623139C74304DC0C71AE27F235441C08C98F54575304DC04A43EF5A235441C012CB6DD575304DC0BC0F2148235441C09CD54C3576304DC0B4162C45235441C0018BEF9B76304DC0CCBA166E235441C0C81766E776304DC067D14980235441C08BBF965277304DC0715B4B96235441C0498164A677304DC01CBDB685235441C0B5F90D0A78304DC096C0FA7E235441C01D6EEB6678304DC05B662F72235441C0B82BF2B378304DC0DD58DB63235441C036D6BD0779304DC0123AE460235441C0F170EC7579304DC0EF60C483235441C0C8F423127A304DC06EA803B2235441C01F11E2847A304DC0738AECBB235441C070C09EF17A304DC03B7B5DAB235441C0C2053B777B304DC028E594BA235441C0BB691D307C304DC0CC8775F6235441C02E327EBF7C304DC01896C62D245441C0BCFD87187D304DC02358A553245441C004BA9A6E7D304DC005C4D846245441C0D614BBCD7D304DC0A223744B245441C0A77294527E304DC0AC8AE256245441C05061C8C37E304DC0E3F8DB85245441C043D5BD107F304DC0147281AF245441C087F4B8AD7F304DC02126ECD3245441C008B1175F80304DC00BC212F6245441C0D515B8D384304DC0748B944B255441C05A03A55E85304DC0D759242B255441C07C47130D86304DC0FF74EA00255441C053AC96A886304DC08A893AFD245441C0156B56F386304DC0046D09FE245441C05029DB4487304DC0A10BDDFE245441C079C4B2A787304DC072E3373F255441C08A1357EC87304DC07C118B7F255441C0BE43E72788304DC0465424C2255441C09250157488304DC0550CC404265441C02264C5E988304DC0AD096B4A265441C04608262989304DC00950CC71265441C0F64C677B89304DC0F23D5C8F265441C0DB94579A89304DC08E87E5AF265441C02727A0D089304DC0E3FD5DE3265441C06879AB048A304DC0F7B6C610275441C0B872AA548A304DC0AC91F23B275441C0A64A1C9D8A304DC030E7C45B275441C098821DED8A304DC097E3EC67275441C019A61D348B304DC0407FDB3C275441C07083FD408B304DC0FF603C10275441C0EEFE7F398B304DC05B0652DE265441C00D03810E8B304DC0C78A3FBC265441C0B15A81E68A304DC01CA7C1A1265441C0B35BA7AE8A304DC097C06699265441C0F51F8D6E8A304DC07560945A265441C0B5033C5D8A304DC08C15DD24265441C01FECBD558A304DC00C7F34F5255441C0BB867A758A304DC00F71E7CD255441C09276CEA58A304DC053CC9EC5255441C0CA6EADE08A304DC0A75B3ED0255441C0BCFDF1578B304DC0208C09EA255441C0611555E48B304DC07EA91603265441C04C43663A8C304DC0DEFB56FC255441C049EF35B38C304DC06A464CED255441C08DF544538D304DC01DF674D4255441C0534D030D8E304DC0235496B8255441C02EAB9AB78E304DC0E993E4CD255441C0BDCD62588F304DC022EBAFE4255441C0713E17CB8F304DC0ED7CC503265441C0EBA7D06590304DC0839C3C2E265441C06EBFEA3F91304DC01D6D1180265441C0BB1F00EF91304DC0584ED7AF265441C08B31C99292304DC05E16CAD8265441C0301FEB6693304DC08BCFDFCF265441C08C51EA2294304DC064985FC2265441C0EDEDDCFA94304DC0AF35C3A2265441C04738CFD595304DC023558B94265441C084EEB94196304DC028D1D6AF265441C08538318A96304DC003E379BA265441C003A38F1397304DC0023BCFD5265441C0BF80989497304DC0FA94DA0D275441C0FC6C854A98304DC025F35B1C275441C0FFC3BFDA98304DC0252A5DF4265441C076FD8A5399304DC08C88B7F6265441C0FFA729BD99304DC0C619842F275441C06E8C9C2D9A304DC026F5E753275441C0E3349D7D9A304DC05BFE5362275441C06E31E0EE9A304DC064CAB34B275441C0349935BC9B304DC0D22D4660275441C0C9D73E659C304DC076FFDB99275441C0BE06C9BF9D304DC0BE026F86275441C00DFC44529E304DC0C44ECC69275441C0D70785EB9E304DC0F1DA9561275441C0296F405B9F304DC02FBB3266275441C0FE310DAF9F304DC0FBBF6659275441C09A17A50CA0304DC06AC6A971275441C06E040949A0304DC0B284497C275441C01CF00896A0304DC08A76CD77275441C093B4B8D4A0304DC0C197B265275441C0456D8628A1304DC0D8EE1E55275441C0853EDD58A1304DC0327B7A41275441C0493E63A7A1304DC0E60F7438275441C0E16054EBA1304DC06F47BF37275441C0D1FC4C85A2304DC0775ECD50275441C0445F4DFDA2304DC096EABB79275441C0FA5E7C68A3304DC0DC50E785275441C018F387C1A3304DC05BCF08AB275441C0A9E3762DA4304DC0192F61CC275441C0E0DE29A0A4304DC003F285F1275441C0E5DA170CA5304DC0E6FBA516285441C05C004971A5304DC0D856A4EE275441C0FCC4C6B3A5304DC0D463BDB9275441C0B13A5305A6304DC01E084A9C275441C004404446A6304DC0F3150A97275441C014FB17A6A6304DC00B00B5C0275441C002473955A7304DC07920A2C7275441C04255B2E7A7304DC0FA8657B6275441C063E76E54A8304DC0F5C17BA0275441C0650420DDA8304DC08C13F273275441C020071143A9304DC0176F7650275441C0C4CB2896A9304DC08EC1B52A275441C0B55BD61EAA304DC0A82C7D06275441C0D6CB4080AA304DC05BA12FD9265441C060B54414AB304DC0E88F6FB0265441C0AF70777CAB304DC019119A9D265441C004B0AEE7AB304DC065013E89265441C048569B9AAC304DC0AC349B88265441C090B5DD5EAD304DC0F8729C95265441C0889DEEDCAD304DC065915BA9265441C0779BEC76AE304DC029E03DAD265441C060CAC51DAF304DC0FFBE4DA7265441C0E87E6278AF304DC0CA2FBB96265441C05CFCFDD5AF304DC03312F98F265441C0AE148627B0304DC0279B9094265441C03194D3F1B0304DC0E1AA91A1265441C0EE544B62B1304DC02F470AB3265441C063E8F33DB2304DC0ABA42ACF265441C0C468A35DB3304DC0D196B89F265441C059E19482B4304DC0EB8F627F265441C01FE35D92B5304DC0C2C47270265441C0ED01518FB6304DC0FFEFF540265441C06159F37AB7304DC0987182D9255441C0E8562D08B8304DC04F2F579C255441C0B405148AB8304DC091A7486E255441C0C44945F2B8304DC08011735B255441C00EC65470B9304DC0BAE5D963255441C0F067EBF2B9304DC0BE06D273255441C00CFEA662BA304DC039F0AC77255441C0B219F20ABB304DC0B8CFFBAB255441C031DF44B6BB304DC074E7F8D7255441C0BC92BC20BC304DC0999E8FBD255441C0A78739FDBC304DC02376F39D255441C027485BACBD304DC04DD04F9D255441C06B69322EBE304DC0A599E29B255441C0CEA843AFBE304DC04BF7C1BE255441C03B06B644BF304DC0AC85DFDD255441C0737C19CEBF304DC063A887E5255441C0A0E3825AC0304DC052C4ACEB255441C044820CACC0304DC0D03B37EA255441C087E34FFBC0304DC0C50F90EF255441C0E94C12C4C1304DC099912826265441C0DD395E4AC2304DC096FF4464265441C030C67DAFC2304DC0C3878398265441C021242E1FC3304DC00A5B4FB2265441C0D62EDAADC3304DC0CC5805C0265441C0EA2C153BC4304DC08388B48F265441C060EE28DBC4304DC066253F69265441C0399E31B9C5304DC0108BB617265441C0E957BC2CC6304DC019E12EEE255441C0EA2AAEBAC6304DC014DF53D5255441C03249EE2BC7304DC0C78EFEC3255441C03055C1A1C7304DC03554B496255441C05F3D2EDBC7304DC0BC7FCA61255441C0BEF28D2DC8304DC08942620C255441C0CC465197C8304DC0FE65F3B3245441C0904B78F0C8304DC05AD68077245441C03E5D3E5AC9304DC0707CCB19245441C0C45720D9C9304DC09D9FF4E7235441C0975E893DCA304DC0090F37E1235441C07EC11092CA304DC0D008C7FE235441C087B892E6CA304DC0EAE6DC20245441C0744B4634CB304DC0A93DB762245441C09D71A376CB304DC0AB3E27AF245441C05B1E42BECB304DC08CB4F206255441C08838B50CCC304DC09D26DA4E255441C05CD4F35ECC304DC00132BD77255441C04E02E61ACC304DC07C65B6F0255441C05B5C9448CB304DC0D4A1A6B8275441C06DC19E7AD1304DC0D444AFF1275441C0B50F8614D3304DC01A385903285441C013B528A9D4304DC08AC97810285441C027D7057BD5304DC048A1B019285441C0ECE0592FD7304DC003FA5E2B285441C0EBA5CDCDD8304DC03DC5702F285441C0BDCA6B49DB304DC0448CCB45285441C082CF5ABEDC304DC0D7F46E57285441C0A08D9FCFDD304DC05BD7265C285441C016B47AADDF304DC093BBE06D285441C08C0EF751E1304DC076AD7576285441C098E9F282E2304DC02ED9BF7F285441C08696E1ADE3304DC0D9895691285441C0E449154DE5304DC05A06EE99285441C073141534E6304DC04D3929A3285441C0EEF0B696E9304DC06222EBB8285441C041D1D4DCEA304DC0847787CA285441C0F7177827EC304DC0043ED2D3285441C0F4BBB982ED304DC0F977E7E0285441C02BBC62CDEE304DC0143132EA285441C0D5E90B52FA304DC046AD6545295441C0302A01AA07314DC0B91BA8A4295441C0FD633E5F11314DC03CBCA495295441C030B81AC417314DC006D5A3DC285441C0541BAB9019314DC0B510F2A1285441C0AED097B81B314DC0BC3AEA55285441C0AE3232001E314DC014AE9C23285441C0A1D260C120314DC094AA0AC7275441C08691B4B622314DC06B9B019D275441C0E8FCC3CA25314DC0AB6CE7E9275441C0B4DD37BF27314DC093B48A2D285441C0C1AC14A029314DC0480EE54F285441C0C64D59762B314DC0D576DD82285441C008542CB32E314DC089536FE0285441C0D0CEDE243D314DC0AB9784C62B5441C07E6BC5B83D314DC06C4C2CE5285441C0FA1FBD053E314DC0B5DDB602295441C0F541F5733E314DC06A18AE12295441C00FE388A93E314DC0E7175923295441C0F68BB2F23E314DC037E2F365295441C0C60EF16C3F314DC0B19745A0295441C013299AFE3F314DC024044AD2295441C00CD21B7840314DC086DF32FB295441C0C7847FDF40314DC06A2DD8212A5441C08AEEB14D41314DC046D2D8372A5441C06CE815D741314DC08445FC3D2A5441C075F0A00342314DC06920D1442A5441C01174884A42314DC0A6E0967D2A5441C0C11AD98042314DC0C9E602AB2A5441C0FE8DF9BD42314DC0D0A43FC32A5441C0142FBE1143314DC0086AB8D72A5441C0ADA8F07C43314DC01B6446D62A5441C091DC07D343314DC08F5CF6C72A5441C090215D2B44314DC08E94B9C22A5441C0AEDD906E44314DC0B0EBE2B22A5441C012BDD10745314DC0952AE3A62A5441C0F78D887A45314DC073DC73C42A5441C0D6101FD845314DC01DFA3CDE2A5441C04921853F46314DC08AD915012B5441C02D991AC246314DC069C819172B5441C04281291B47314DC0412BD52A2B5441C0FD9BAC9747314DC0112F27652B5441C078A73E1A48314DC0AA0488892B5441C07D463E6D48314DC06463B3B42B5441C05E2B5DCF48314DC01ACC66C52B5441C0D5417F3149314DC00273AFE02B5441C04EFF367C49314DC0939955EB2B5441C04DB00ADC49314DC05EDE01182C5441C02479415C4A314DC00408B29B2C5441C059F3C2B34A314DC06EDB1DE52C5441C04E8ABD064B314DC0500F76252D5441C0A6A465704B314DC0403CE9522D5441C09460DBE04B314DC0BD62356E2D5441C0F3E1A4374C314DC0430BB8852D5441C02CE56E8E4C314DC01DCB18AD2D5441C0246044C94C314DC0EF5584DA2D5441C01BE496FF4C314DC049FB60002E5441C0722862314D314DC0AEA3A71E2E5441C06528E7AA4D314DC0CDCBF8392E5441C03DAD15194E314DC057649A602E5441C082CDBD574E314DC0E552806D2E5441C0D04095954E314DC022370CAA2E5441C087E17ADC4E314DC0D03324EB2E5441C0540A8B384F314DC0D5902B232F5441C08579CB8A4F314DC0AD6AD44C2F5441C085ABFCD34F314DC06F156A702F5441C002D07E2550314DC0A34D917C2F5441C0BCE4AE4650314DC0F5909A9B2F5441C051DF108650314DC01C2DB2C02F5441C098AFDEDC50314DC058CB41DE2F5441C0AC1B0C2651314DC07C45BA11305441C0B865B24551314DC023583B4B305441C0A225DE6951314DC0AD04DD93305441C093641C9751314DC09E62E7CE305441C054E3E59051314DC09D452B85315441C0458285F359314DC07E4C7560365441C0B164F2C65A314DC03D119825365441C09BEA240D5B314DC0462B7F32365441C0F1C7B9675B314DC0D1496E42365441C0EF9A34B35B314DC01721E956365441C0211DFF895D314DC0E0D23381375441C0268D14A85D314DC0CBBD88FF375441C000CAD8E55D314DC0CA2FEA9F385441C07EA61D1F5E314DC093FA4E05395441C0281AA6515E314DC07B9E5640395441C045548D985E314DC04E8D617B395441C0C50A7CD95E314DC0A77DF57F395441C08012E63D5F314DC0AD477C7B395441C067B989A45F314DC057DDF08C395441C09704FFEC5F314DC0F4A667A1395441C058FE864160314DC02FD1F6BE395441C02B98D59C60314DC0E386E7ED395441C077D69DF660314DC06C88DB1C3A5441C0BB827A5661314DC070D5B13C3A5441C0346BEC9E61314DC08FC652473A5441C015B2015574314DC023A57105475441C0226C09B474314DC0E2BA9468475441C0CD3626CF74314DC04EDE34B1475441C0A73B41EA74314DC00A596401485441C03E1981F274314DC0A744A93E485441C081898CFE74314DC01121C366485441C09913052275314DC065A9F57B485441C0FF5EDE5975314DC0112AD988485441C0838D638975314DC06E98A7A8485441C0660BB4BF75314DC0CD9157D8485441C025C836EF75314DC09176DD14495441C05928311A76314DC02F46604E495441C09145943776314DC0916E718F495441C019567C3176314DC05884CCB9495441C047E5F23276314DC0855910F7495441C0A7F0D45476314DC0D79015514A5441C00453F19476314DC01CD3AF934A5441C088E3FDCB76314DC062C77FD24A5441C0C7057D2077314DC0437A9E164B5441C0EAE8993E77314DC0FECBB4764B5441C0E991295577314DC01F37ABCA4B5441C0DB04134C77314DC06843ABE94B5441C05AF9754177314DC03DF3A1214C5441C0C408B74677314DC0582E37484C5441C00B425D6677314DC038B73B834C5441C0E3F0178F77314DC04B087ABA4C5441C0ECDBFFB077314DC02B2F87FB4C5441C029203EB977314DC0BDE380334D5441C071B4ADB777314DC05838D1764D5441C0CDADF1BF77314DC0B120BFA84D5441C0FBB1F8F377314DC00D988EE74D5441C00E49E41278314DC05B29660D4E5441C0963BCE3778314DC0C662985D4E5441C0341A096578314DC0F38B7FA84E5441C0F645029078314DC0DD8F4DE74E5441C09FCB76B678314DC011CA220D4F5441C0AD03C2EC78314DC0E9AE86534F5441C04CFAC01A79314DC03D2DB9A34F5441C0AC92C55179314DC0D3C06AF24F5441C010B6C78E79314DC0CD917F8D505441C0B7A924AC79314DC069520CE9505441C0BD0251B179314DC0F23D1A68515441C008AF79D879314DC0D0AF50D7515441C00274F70D7A314DC0BA707C40525441C0545F9F277A314DC0E3BB3C5D525441C088F530637A314DC086A04B9B525441C09CF262877A314DC04EDEF9CA525441C0E9322EB97A314DC0623BEDFC525441C0F163DA587A314DC04A51A8DE545441C046D5C19979314DC02D01CE56555441C0547341D57E314DC06D553CBE5A5441C098CCDF737F314DC02D8C10625A5441C0543364ED7F314DC029CCA7825A5441C01200634080314DC0C2D9DFB35A5441C0AC42C47C80314DC0133B1CCC5A5441C07D9A35CB80314DC08D6B571C5B5441C05982621481314DC00075685A5B5441C00AD94E5E81314DC0E2613B995B5441C0DB129B9481314DC0B007D4DB5B5441C03A6CBE3382314DC08A1BCD805C5441C0488C8C8A82314DC008B10D995C5441C0704462C882314DC00C356FDF5C5441C0EAFCE4F782314DC0F05FBA1C5D5441C0A81F116F83314DC071860A925D5441C0066AE9A983314DC05730AEBB5D5441C025F9E70E84314DC0161E46715E5441C0F21B573884314DC023D4E8D85E5441C08CB6C1AE84314DC09CFA7C505F5441C00B6EB1F284314DC0928C56575F5441C0E4D7772185314DC038340D6E5F5441C01FCB334785314DC0F7D08E885F5441C07B24AC6D85314DC0395C8FA45F5441C03A73E8BC85314DC0AB9B61C45F5441C0AC183DF085314DC0738345D15F5441C046E92C3786314DC0B15E82E95F5441C0C8887F6D86314DC0612CE110605441C0AA8F218A86314DC074709646605441C019B2CAA686314DC0EB493570605441C016FC7FF486314DC0AC55289F605441C04D32801987314DC04FE4F5A2605441C02468C6B887314DC097DCF0B2605441C06E16770088314DC08E53F4CB605441C02147382988314DC0153AF5E7605441C024474F6088314DC0EA85E5FA605441C013326FBF88314DC06E90EDF7605441C029345F7589314DC0633CD9FE605441C0EEE772F389314DC0BD49E0F8605441C0B42C08738A314DC0A2DE39FB605441C012FFD6F18A314DC07CA12021615441C0BB29ED538B314DC01B5DEA59615441C071650A9A8B314DC0C0EBD6C3615441C01988CBA68B314DC05A290B17625441C05919D0B88B314DC00EF9FF86625441C0196E62CF8B314DC0531E61D0625441C046EEC7E98B314DC076ED37F6625441C0715DBFEF8B314DC09277E044635441C087BD22108C314DC02C453D8B635441C0CE82B3458C314DC02B9670BC635441C0D03850848C314DC06B73F6F5635441C0BEF779CA8C314DC07FC12E2A645441C09753D20C8D314DC001F27480645441C000568A5D8D314DC0DCC168CE645441C054E9C5B28D314DC0E97EA821655441C072E43ADF8D314DC011A28182655441C0F4239AFC8D314DC0A2C5DCC8655441C0C71667128E314DC09A4F322B665441C03C86AC1D8E314DC033773969665441C00467B14E8E314DC0CEDA77A0665441C01C2B6E7A8E314DC0993D8BE1665441C0F9DFC0B68E314DC0F1BE6726675441C0EBCDFDE08E314DC0A4748D51675441C00C7A8FF18E314DC02DD77D86675441C00F630EFC8E314DC0EE10DDCF675441C0E0DB29178F314DC082E84B1F685441C06A93F82C8F314DC0AC77147A685441C0B6BE043F8F314DC06BDF81C9685441C072EA826B8E314DC0F4844B55695441C008AB0EBE96314DC0B787FFB4725441C0A05AB56297314DC05931B065725441C0703A40C697314DC03D5392E5725441C0E6D4670F98314DC069FFD53B735441C0ABB1115498314DC027E4E55A735441C088EC469D98314DC02F1F1D70735441C0171B44E798314DC02676FD79735441C0FB54D13B99314DC076EEF770735441C0CFB8188B99314DC02D91F167735441C0C37D04CC99314DC08C5AE37A735441C0821C57029A314DC0CFDB03A3735441C0C9DD454C9A314DC0F03CC0D8735441C0FA12D5849A314DC0738CC110745441C03349EBE39A314DC004400E4B745441C0A058AE3A9B314DC072FB847B745441C065AA99A99B314DC0D713DAB8745441C05BD0C5F59B314DC026D99B0D755441C0C5B97E719C314DC026044F75755441C0E26CF2C29C314DC0659C75DB755441C08A6168F29C314DC0107D943E765441C01DCFD6189D314DC0B5598D92765441C0A06F58459D314DC0D42DBFC3765441C05E2B2A7A9D314DC09AB676DA765441C05175A6C29D314DC02DCCF2D2765441C0BE2847FB9D314DC0956A52BF765441C0C7DF4E4E9E314DC00B4978CB765441C054A1D77D9E314DC03A7DCCEF765441C0DE7933959E314DC08F8DC827775441C09EAC8E879E314DC0F5A77A5D775441C0274DC6899E314DC072637395775441C037324B919E314DC03FD0D1BF775441C0CD33E0D29E314DC081417827785441C09D1BDD229F314DC01093514A785441C0C13451689F314DC0B42F244E785441C02012C3AD9F314DC0746ED861785441C00DC659C19F314DC09104DD80785441C00A41D8C59F314DC008700EB5785441C04B002DB59F314DC075BC87EE785441C0305483549F314DC070CC1218795441C00751A3FA9E314DC0A60A0C3A795441C00D13A3DB9E314DC0884FC172795441C0286498E19E314DC0A3AC3FCB795441C04880B3FC9E314DC05429F61C7A5441C0131B3C0A9F314DC0B854E14E7A5441C0151B20489F314DC02CCCB7717A5441C0E4DAF9829F314DC0E79DFF8F7A5441C00BCAD7C09F314DC0669E59B47A5441C0A8920DE89F314DC084F219ED7A5441C0F23CDD1FA0314DC0044D1C257B5441C01AFE8B64A0314DC0C01FE2417B5441C0EF24A1BDA0314DC0937A283E7B5441C0C4DC411BA1314DC0091BE6357B5441C0CF5AE97EA1314DC0873B7F3A7B5441C0FBD678B1A1314DC059BE61477B5441C08FDCA4D2A1314DC0ED50157A7B5441C0B3E2E4DAA1314DC041F628BE7B5441C059B012D7A1314DC0DC6EF7E37B5441C0379748D9A1314DC0DDAF80237C5441C04B13B7FFA1314DC0AE147D777C5441C0F01A5C1CA2314DC04D8319A17C5441C0E4C76A50A2314DC01052F4C67C5441C05DAD297CA2314DC02A5BB5FF7C5441C08FE8129BA2314DC0D780D42A7D5441C0C80D80C4A2314DC03F141EA37D5441C04AACAAC9A2314DC0A5D610137E5441C005B85CF5A2314DC0C83AD7897E5441C03007182AA3314DC0AE091F027F5441C0F52FD758A3314DC06F2A6B3F7F5441C0A9D71C86A3314DC0718FB55D7F5441C06F0DE9D9A3314DC07F3596677F5441C0EFE72D07A4314DC01A31BD767F5441C04358E52CA4314DC081CDA9A57F5441C0253E5850A4314DC0A95491D47F5441C0870DB96AA4314DC05D6CA0F67F5441C0254F3C94A4314DC0E8B6CC08805441C0962B1FD2A4314DC09A4EF617805441C0D7BFE8FDA4314DC052F5A228805441C058772006A5314DC087CA0E78805441C07FC67BFBA4314DC0ECE60CD2805441C091204005A5314DC002263F06815441C064F7AD25A5314DC0519DE532815441C0F82EE06EA5314DC0DE49BA55815441C06DCA7FD2A5314DC0C604356A815441C07BC59F34A6314DC072F31C93815441C0EDB47069A6314DC0804E9DAD815441C06F603573A6314DC06B073FDA815441C092C453B0A6314DC0BBE298FE815441C0592BD804A7314DC087A70B2F825441C0CD80EF69A7314DC09412067D825441C050ED8FABA7314DC02DDF75AD825441C0EB841FBFA7314DC0C35E7604835441C091AF51E6A7314DC042540B47835441C042BF862FA8314DC07302D363835441C0204A4C86A8314DC064FF8190835441C0FB75AEA0A8314DC0C81768BF835441C040FD89B9A8314DC0178BF2FB835441C033EF671CA9314DC0BED57E19845441C06E36BD96A9314DC0E957730A845441C09AA197F3A9314DC03E0EB906845441C02960A774AA314DC004CCCE25845441C02F55B6CDAA314DC044CD4556845441C023554C0CAB314DC00852E49B845441C011E79542AB314DC0782419EC845441C0E8A72E7BAB314DC0BDC23814855441C0F106B6B0AB314DC05D23D156855441C0563F8DEEAB314DC0C3668FAB855441C034046C2FAC314DC07F7D15E5855441C0EF52BF65AC314DC02113ED0A865441C0D62FA1A3AC314DC01C9FA31E865441C06CD5A5CBAC314DC03472A01B865441C0BE205C41AD314DC053C2D565865441C0A46114BAAD314DC044EEF3A6865441C0E339DD10AE314DC062C928D8865441C09BC1FF75AE314DC01E20BAF5865441C01F770ACFAE314DC0CE1A3126875441C0174D3615AF314DC03DEECC4C875441C00161DC17B3314DC00FCFD4B8875441C039279C20D5314DC099FB6C8BD55241C08E26B2FED5314DC0FB162DC8CA5241C03C5C573C76314DC03F09F639C65241C01FD89FA1CA304DC08F95ED959D5241C007132EE139304DC08BBFE0B57B5241C053C6540403304DC0576DD8296E5241C0487FB1F2D32F4DC02A81E3DA625241C0","BARRACAS",6264.00535517,2063380.77761,12432,6402,6030,4,30
50,"0106000020E61000000100000001030000000100000012000000BAA779885F304DC07F41CA94765041C02F30A6145E304DC04585AEB7755041C0C3F96BC712304DC046BD018A4B5041C0688928B7F12F4DC095AC7B073B5041C0C963E9C9AF2F4DC05D21233C395041C02DF78CF7862F4DC08E28487D365041C03F0C27B47B2F4DC0FB860618365041C03548A3B3712F4DC022BD5871935041C0C75057FB642F4DC0BFF4439C1A5141C0ED9785AC5F2F4DC0A9B445F8385141C0BEECEFDE542F4DC0E45D88C3765141C05D181B8F542F4DC0EC731DCE785141C084BEE739FB2F4DC0C7EEA3538F5141C0D103219C0C304DC0FE73015E345141C089E9DD7423304DC05996DE7FF15041C07753668144304DC0280F76BEA25041C0126E8F1E5A304DC0DB5A5193805041C0BAA779885F304DC07F41CA94765041C0","BARRACAS",3266.19759078,587880.989113,14660,7071,7589,4,30
51,"0106000020E610000001000000010300000001000000190000004033573B502F4DC045FFDB37955141C07D880A71422F4DC00A318FBFEF5141C0A7AF046C1C2F4DC076D4F1F2EE5241C087320F1E0F2F4DC0D476DDAC375341C0917EB5842F2F4DC0AF538F25495341C058BB62E9502F4DC027519AEB5E5341C027270F93572F4DC02FF73F476D5341C09EB2FD8D5C2F4DC09FE4BB1A785341C03217FB60512F4DC0FA42591B9D5341C0CADDCE2D552F4DC0D38F7D77A85341C0855D4C13662F4DC08E4A26E9B55341C0FDD5C5AC6F2F4DC03F6A0139BA5341C0AB0F8AE7892F4DC0CAFD607A745341C0C18D4C39902F4DC052993BAF5E5341C023A4AAD89F2F4DC0195CECFE3D5341C0C3E839AFB32F4DC05AD8D4740D5341C0105B8781B82F4DC0A4DF542AF75241C00F685140C12F4DC0ED81091FC65241C0487FB1F2D32F4DC02A81E3DA625241C0F582645BEC2F4DC06B5F8E41E15141C03E0E174FF72F4DC0730F83C4A45141C0C43F8E87FA2F4DC0F7F5A1FC925141C084BEE739FB2F4DC0C7EEA3538F5141C05D181B8F542F4DC0EC731DCE785141C04033573B502F4DC045FFDB37955141C0","BARRACAS",4506.27161331,743971.453705,10026,4941,5085,4,30
55,"0106000020E6100000010000000103000000010000009E000000B58EC0844E334DC092C8015A815441C0AFA8772951334DC0BAEC7FE87F5441C0A15E32CF52334DC0A657E9717D5441C08F42C7A455334DC00633B8107D5441C0FC84AF1D57334DC013C35B1D7C5441C05EAB671F59334DC0E328503A7A5441C085590AA95A334DC0688C92A0785441C05FE850105F334DC0C143AAF1775441C00D4F778164334DC0C6FEDB8B765441C047BDACD668334DC09724227C755441C0EF5D27DB6D334DC07F6F0BCC6F5441C04707A4AD6F334DC0B666BF2D6C5441C08337004971334DC02C90ADA16C5441C050FB426974334DC04064C37D6C5441C01801553177334DC003D144A16B5441C059BAD2517A334DC02AB624576A5441C0D6F21CC07C334DC068E83C31695441C0EE96CB4481334DC00AE4109F685441C0EEAF3A1785334DC032617F7A685441C06D8495D789334DC0611891C5675441C0880AD74A8D334DC059D3A8F5675441C0B9D69D0293334DC07462154B685441C0F84DAE9994334DC05ED83672675441C02819BB5F95334DC0603BA82B6A5441C07EBF91359E334DC0596090146A5441C02E0221709F334DC053295958675441C0D52A5F5FA2334DC0989886E9665441C01EF3D2C7A6334DC07A604FF4675441C0901240F3AA334DC004005650685441C083899A9AAF334DC017D2AB16685441C089C91825B5334DC048AEA557685441C0DCF42210BA334DC0A4FC4382695441C0279085E7BF334DC010CE4B7A6A5441C040A526BFC2334DC0A245A92E6B5441C02F7CFEE5C6334DC04526FDE96B5441C033862096CC334DC074CCF0D86C5441C00492AAE2CF334DC082B78C3A6E5441C0A127544DD1334DC01EE7CCD2705441C0208BFA4ED5334DC0E4D39B9A725441C039F03FF3DF334DC09C8EE998745441C087303BBCE6334DC078EE796A755441C0A7BEE246EA334DC06A078E9A755441C0719CE969EE334DC0CE2B05A3765441C007AB20E7F1334DC058981200765441C0A8D9EA9AF5334DC0F3320272785441C03693C99EF6334DC02A7D89C67B5441C07545AEE303344DC0E910E1007E5441C05A7A5BB404344DC0C1C3144E7C5441C025582FA807344DC0A9DEF27F7B5441C0DCE413A10A344DC01084201F7C5441C0C87203F10D344DC06E9BF6667B5441C01D32A3E112344DC06F661AF67A5441C00DD0602816344DC06E3B0DFE7A5441C0FAEEBB5418344DC06F2F43367B5441C0B86C7E411D344DC07E895D387B5441C0A02CAAE01F344DC08DF4E4187B5441C042C3726523344DC0CA75566B7A5441C0CCB7345628344DC0F63F032F795441C0D7B0AAB137344DC06636B698765441C0AFB474913C344DC02C9FCD6D775441C076B3E8B641344DC0815F8507775441C0D51F311B47344DC01CD337AC755441C0285709F14C344DC0757B0841725441C0807F8E1C54344DC09ED40BD6705441C0037960F45A344DC026E8C5BA6E5441C0DD99BF965E344DC03883120C6D5441C033F0F1D063344DC0AA01CD706A5441C05E76B23C69344DC001911A7D695441C07D0CFF3A6F344DC0534D39F5675441C0EB5E3E6B72344DC0D3FA346F625441C0FCBEBAD073344DC0EE3FE500605441C0CC3645A575344DC0ACDD5AA3615441C06EADDFCE77344DC043EF6E48605441C093CC95C577344DC00DD73B0C5D5441C0BC97D9FC7A344DC0B142A4A25A5441C0F87DA0137F344DC04E3A271A585441C07F26CCF980344DC09CDC5C1A585441C01DE5F3DC82344DC04882993C585441C096E2E0D885344DC0C11A49A2585441C059CE89E987344DC0C5CD8059575441C0769AC8D88A344DC024A263EB565441C01FC560E68C344DC06310C0EF555441C0C999319C8E344DC0AA50F349565441C0DEB3CAB38F344DC0BD1D8786545441C0630A9F2291344DC002FD12F2545441C080F9BB0292344DC059C52FA6555441C0490FD80E97344DC007755E09535441C0299BDF209B344DC0AD43C6BD515441C0B5131B639D344DC07503501D525441C0D68E0F8A9C344DC092CE947C545441C05F1483069C344DC00F45D0AB555441C023CD8F689E344DC05BA7054C555441C0C7448386A2344DC0E9F8DDE7545441C01FB8983BA7344DC007CFA1A1535441C04718640BA9344DC021E43FF7515441C0D373FBE0AE344DC06EFB17FA4F5441C0BE932D77B1344DC08D06863C4F5441C0ED86C00EB6344DC001A47B684E5441C059537A91BA344DC05E687EA04B5441C0F53511E1C1344DC0B74CFD094B5441C018EA8EA9C8344DC06616C3214A5441C011524562CC344DC05E7552534A5441C0C05D7276CE344DC040AFA89D4A5441C0C3A512D3D1344DC0BDA1FDB94A5441C0693980DCD7344DC0E870AD2B4A5441C0D43B1CF5DB344DC0E1DECF264A5441C060F64F30E0344DC04A6D501C4B5441C0F40B64B3E2344DC0777330DE4B5441C0D209AECFE8344DC034C8059D4B5441C067DC0963EE344DC0C58211FE4C5441C06F94545EF9344DC0CB0A96A54D5441C09AFCC6DCFC344DC064D689BB4E5441C0F5947FA1FF344DC09BFB16CC4F5441C0A9089CA602354DC096D98B844F5441C0CFDF6E9B08354DC01D775689505441C04BDC03A00E354DC0D557AE27525441C0A3ED9F1D19354DC0C8EE5257555441C05A5D06CF1E354DC0C6BCD9FF575441C0922B89E122354DC0C4D4EF6D585441C0B9DFA68C24354DC06034C8AE595441C0846A5D792A354DC04785BB7F595441C0B042049030354DC0A0ECC7915B5441C0CC9EB0F434354DC0E503D7E85C5441C09556661E38354DC00898872F5F5441C09178ED9B3D354DC06A87F569605441C02B8C3F8F43354DC05DDA8C94615441C03769507B4F354DC067DE0CCB625441C0F7AB6C874F354DC022CE66910D5441C0869F0DE24D354DC05B782685FE5341C0BD7FA14D4C354DC04D832377785341C0239B69C64A354DC0D5C2C627155341C0142F518D33354DC0EAC03550145341C0575F659C19354DC031240884125341C065EDC837EC344DC0921CCC590B5341C097DEDE0BC0344DC0E27DE486035341C09020EEC0BF344DC06BEF9ACD045341C0723D6359D6334DC095344C02DF5241C038A1B3198D334DC00C387DDED25241C06D3A6C849B334DC09F20AFAAE55241C0C76633F9A4334DC028EF5AFFF15241C03D6E62D6C3334DC074F175BD1A5341C09F979BD6C5334DC0DBD804851C5341C04263182DC7334DC0E7DD3DB51D5341C04E4DE48FCA334DC0DFDE9FB7205341C065929335D8334DC09EEA4A3E2C5341C09BDC220ED4334DC0AE80C1E7335341C07B6F0010C7334DC04A3304464A5341C09F2DEF73C4334DC0D7F597874E5341C0751B6561B6334DC0F8FEA6AA715341C03ECC8E2DB5334DC05E6E0F11755341C0CA7124B7B3334DC010BD4232795341C04988A7C6A2334DC0F4603D86B15341C01F04AA429D334DC0BC447EDEC35341C005B41EE58C334DC00DD10B30F45341C0CFA1038975334DC0DC27E61B2B5441C0875008DF5A334DC047036E966A5441C0F59C6D6D58334DC00C319B426D5441C0B58EC0844E334DC092C8015A815441C0","NUEVA POMPEYA",5612.38238646,1485052.82132,9973,5150,4823,4,33
56,"0106000020E61000000100000001030000000100000062000000920746A5F8354DC036E92F40DD5241C055ED2473C8354DC0B5447B51EB5241C037AA39B8C2354DC04D2B0D54ED5241C0D7F190F5BE354DC04EDD0337EF5241C0B034058CA8354DC06DE3B35AFA5241C0EFC4B32AA6354DC03203B280FB5241C09A53A61E9A354DC05376255CFF5241C059337A7492354DC086BEF4CF015341C04917458993354DC0E8D1CD70035341C09A3ACE1C95354DC044B4C8CE055341C008B2B1F592354DC0EC39624B065341C01D41136A90354DC0C3EBBF9E075341C0984E6A9481354DC0C986504A0D5341C0B71B33117F354DC0D73018DF0D5341C0696C578C7D354DC0623E0BBB0E5341C098FA07167A354DC0CDECEE860F5341C0FAC7985E78354DC0C11BC356105341C01229548275354DC00F1CD5D7105341C0857395CB74354DC0480F5858115341C04F61927970354DC07B3DB566125341C07CDF92E96D354DC07BC9F8A2125341C0841858F46A354DC0E3F65283135341C033465A3067354DC06ADB76DB135341C041E932A065354DC0050BE65B145341C00FE75CAA61354DC08E9328E5145341C0277553B85D354DC0CFDD9342155341C0152A53165A354DC02798DA6E155341C063A16D0B56354DC03F19BE54155341C0A4A9ABDF55354DC0A877A52C155341C04823E2B555354DC069AADD38155341C063DF935E55354DC004166852155341C0804AD45D55354DC013786452155341C0239B69C64A354DC0D5C2C627155341C0BD7FA14D4C354DC04D832377785341C0869F0DE24D354DC05B782685FE5341C0F7AB6C874F354DC022CE66910D5441C03769507B4F354DC067DE0CCB625441C00DBE59485C354DC018BA1419645441C08B86B76585354DC0B509349E6F5441C0196472B8B0354DC039EE917B7C5441C0BFA51954DF354DC055EA72078B5441C0AEFF2AA7FE354DC027A6E194975441C08B8FBACE13364DC0004998C9A15441C0036DDA412E364DC01CC2594FAF5441C07BDA040E42364DC09D407D31BB5441C0031E26CA46364DC00E6DA63ABE5441C0B29EF2FD68364DC070818E62935441C01EE04E917F364DC074E36B86775441C047CDEEA392364DC0EB30D1FE5F5441C08C861FA795364DC0BDE549805C5441C036586C169B364DC013D42031565441C0FAECA5C6A0364DC0FFEAE6D54F5441C0CCD358F3A3364DC0366300494C5441C085D394C7AE364DC062D13E76445441C0ED285DF0C9364DC0C70750F5305441C035E2A807E5364DC0CFA3F3811D5441C03E6AF34CFE364DC03348E7550B5441C0189D125033374DC0706BA242E55341C051EE6DEA4D374DC014D380E6D15341C0F8E8AD7D71374DC0BE24B8D6B75341C00B6E84EF94374DC0705B503B9E5341C0F3D914659B374DC0FD42571D9A5341C0C53BF5536C374DC0AC8B0AAD745341C0FD14950050374DC0137340B55C5341C000CD70D74D374DC0C756B0E15A5341C0ACBF303544374DC05276CEAA535341C0D5FAB74439374DC0ACF99BF34A5341C032814C102A374DC0B51FD8D73E5341C095B255F828374DC075D6F2E13D5341C05CAF583018374DC002913A2D2F5341C03FC5268118374DC0751AB7ED2E5341C0E0884B37F5364DC01F035B810E5341C0C683934FD6364DC019052E49F35241C0CCEC13F2D0364DC0E9C3B237F05241C0D17B674ECB364DC01EC25BFDEC5241C0B8348F25B7364DC0CFCDB917D85241C00F94CD15B1364DC0797CC552DD5241C0A4028D95AB364DC0F61976CFDA5241C07BD1F9C0A4364DC069E2684CD75241C0513767429E364DC0E8933668D45241C07A57FB5895364DC059C1167BD05241C0EB6F320590364DC0D4F72D9ECE5241C0A8BD13118C364DC01DB5799DCD5241C0B4F29AB385364DC0AF94A2D2CB5241C0F4449E0A7F364DC031C1ED54CA5241C028D876B277364DC0AC0D011FC95241C013DCE1CB73364DC0706F758AC85241C01AB314086A364DC03226D3F8C65241C08F5A321261364DC062258274C65241C0BFD4A76954364DC0942A84ECC65241C068A734564B364DC0B008FB98C75241C079E4356544364DC03AE866A0C85241C00B4580D63B364DC043C60148CA5241C0A0CA613536364DC0DDF2016DCB5241C0D18947B529364DC06AD26F8BCE5241C05F4ECB661C364DC098CB4218D45241C06FDCBA3A15364DC0E06B0C99D65241C0920746A5F8354DC036E92F40DD5241C0","NUEVA POMPEYA",5312.17666961,1802978.85302,9544,5032,4512,4,33
57,"0106000020E6100000010000000103000000010000005A00000023CE74F6E7344DC092B9B9E15D5241C0F7EF760ECE344DC0DC8E95AEC65241C097DEDE0BC0344DC0E27DE486035341C065EDC837EC344DC0921CCC590B5341C0575F659C19354DC031240884125341C0142F518D33354DC0EAC03550145341C0239B69C64A354DC0D5C2C627155341C0804AD45D55354DC013786452155341C063DF935E55354DC004166852155341C04823E2B555354DC069AADD38155341C0A4A9ABDF55354DC0A877A52C155341C063A16D0B56354DC03F19BE54155341C0152A53165A354DC02798DA6E155341C0277553B85D354DC0CFDD9342155341C00FE75CAA61354DC08E9328E5145341C041E932A065354DC0050BE65B145341C033465A3067354DC06ADB76DB135341C0841858F46A354DC0E3F65283135341C07CDF92E96D354DC07BC9F8A2125341C04F61927970354DC07B3DB566125341C0857395CB74354DC0480F5858115341C01229548275354DC00F1CD5D7105341C0FAC7985E78354DC0C11BC356105341C098FA07167A354DC0CDECEE860F5341C0696C578C7D354DC0623E0BBB0E5341C0B71B33117F354DC0D73018DF0D5341C0984E6A9481354DC0C986504A0D5341C01D41136A90354DC0C3EBBF9E075341C008B2B1F592354DC0EC39624B065341C09A3ACE1C95354DC044B4C8CE055341C04917458993354DC0E8D1CD70035341C059337A7492354DC086BEF4CF015341C09A53A61E9A354DC05376255CFF5241C0EFC4B32AA6354DC03203B280FB5241C0B034058CA8354DC06DE3B35AFA5241C0D7F190F5BE354DC04EDD0337EF5241C037AA39B8C2354DC04D2B0D54ED5241C055ED2473C8354DC0B5447B51EB5241C0920746A5F8354DC036E92F40DD5241C06FDCBA3A15364DC0E06B0C99D65241C05F4ECB661C364DC098CB4218D45241C0D18947B529364DC06AD26F8BCE5241C0A0CA613536364DC0DDF2016DCB5241C00B4580D63B364DC043C60148CA5241C079E4356544364DC03AE866A0C85241C068A734564B364DC0B008FB98C75241C0BFD4A76954364DC0942A84ECC65241C08F5A321261364DC062258274C65241C01AB314086A364DC03226D3F8C65241C013DCE1CB73364DC0706F758AC85241C028D876B277364DC0AC0D011FC95241C0F4449E0A7F364DC031C1ED54CA5241C0B4F29AB385364DC0AF94A2D2CB5241C0A8BD13118C364DC01DB5799DCD5241C0EB6F320590364DC0D4F72D9ECE5241C07A57FB5895364DC059C1167BD05241C0513767429E364DC0E8933668D45241C07BD1F9C0A4364DC069E2684CD75241C0A4028D95AB364DC0F61976CFDA5241C00F94CD15B1364DC0797CC552DD5241C0B8348F25B7364DC0CFCDB917D85241C0D17B674ECB364DC01EC25BFDEC5241C0CCEC13F2D0364DC0E9C3B237F05241C0C683934FD6364DC019052E49F35241C0E0884B37F5364DC01F035B810E5341C03FC5268118374DC0751AB7ED2E5341C05280CB1C4A374DC0A702DF26085341C062642BD06A374DC015F35147EE5241C048E71E8179374DC03BA16024E25241C0B138BF9E85374DC0772BC5B8D95241C01410EBB59D374DC06FA0C254C65241C06456276E9F374DC08B6E068CC45241C0ABA34185AB374DC036DEBBFCB75241C068F87ACBAB374DC0FF5A62B3B75241C0A42EFCA4AB374DC02FE0BDA2B75241C08C8CC64E5E374DC07CE9BEC0955241C03827BE3A4F374DC0B40B4EB6945241C0E8F57FF356374DC07123919C245241C0AC2C13F82D374DC03D9E7BCD1B5241C0EA2A93FE2A374DC079CFE6291B5241C022481F7614374DC0B3797075175241C07E4CFE7707374DC0C1F7708A155241C0CCE7CF1F01374DC0B1E6FC9A145241C008A90C9F34364DC0DDF0562BF25141C097063D79B2354DC04074C5F4DA5141C0A125D396E2344DC018A6D9C7B75141C033BFB0F2A3344DC0D2170D38AD5141C04BDF2486B6344DC001904C1CDF5141C08ACEDAA0EB344DC0534C629E5C5241C023CE74F6E7344DC092B9B9E15D5241C0","NUEVA POMPEYA",6341.98611558,1681075.20221,18768,9532,9236,4,33
52,"0106000020E6100000010000000103000000010000002600000062A50F0D422E4DC0531F4AAFE95141C059BD4710322E4DC0D2690735035241C071A90DB5E22D4DC0AA199B761E5241C07977190DD72D4DC09BFD35C2285241C096AD7A45CB2D4DC0493D2FA0455241C083FEB9B8C12D4DC00455ABEA5C5241C0987AB092BC2D4DC0A336E50A705241C0F655AB87C52D4DC033C830C98E5241C0E57B0663EB2D4DC00C70E7079C5241C050EDE6D00D2E4DC0F359CE90AF5241C0EF37815D112E4DC00ADF0492B25241C0FC219E6F312E4DC0B43F767CCD5241C0348A07193D2E4DC0AB1A8C68D95241C07DF53594492E4DC01FAD1321E85241C09AC84B4B462E4DC0E2466F99EA5241C04DEB90784C2E4DC0FF92CBDAEF5241C00618A4704E2E4DC089ADCAEBED5241C09F199FE8612E4DC0ED378F7AF85241C0F6FD67EC742E4DC01AFC842CF95241C03DF24169892E4DC060D99983F85241C06EE99870952E4DC0E2FF4271F75241C0DECCA0F5A22E4DC0FCA06D27FC5241C07F51F5D9AC2E4DC09C580538045341C0079D7FABBC2E4DC0EB0B070D0F5341C03FD0C31F0B2F4DC0E7D38ACC355341C087320F1E0F2F4DC0D476DDAC375341C0A7AF046C1C2F4DC076D4F1F2EE5241C07D880A71422F4DC00A318FBFEF5141C04033573B502F4DC045FFDB37955141C05D181B8F542F4DC0EC731DCE785141C0BEECEFDE542F4DC0E45D88C3765141C0ED9785AC5F2F4DC0A9B445F8385141C0670C4242DF2E4DC0C18C9ACE2C5141C08C061972C02E4DC08D2383BB1F5141C04894CEBDBF2E4DC0E82984731F5141C085CFF099AA2E4DC0677D2D693F5141C07DC69BE2442E4DC0FEC4A8FFE85141C062A50F0D422E4DC0531F4AAFE95141C0","BOCA",4870.19626713,1204670.05367,12484,6524,5960,4,48
53,"0106000020E610000001000000010300000001000000230200004C0593BA602D4DC0D6973DB4905041C0B22047B5602D4DC0CE260BBB905041C0DF7CFBAF602D4DC0E2C115C1905041C0A8D8AFAA602D4DC06D8B21C7905041C0327E68A5602D4DC0EE552DCD905041C05BDA1CA0602D4DC001F137D3905041C0B8F5D09A602D4DC0F77F05DA905041C0E8924A96602D4DC0497611E0905041C00EEFFE90602D4DC05B111CE6905041C0CC4AB38B602D4DC0E3DA27EC905041C0E8AF6B86602D4DC0CF6AF5F2905041C0740A2081602D4DC0C0BF04F9905041C09366D47B602D4DC0CF5A0FFF905041C0CD954C77602D4DC0CC501B05915041C01FB10072602D4DC0BFDFE80B915041C0380DB56C602D4DC0CA7AF311915041C09D206F67602D4DC09D45FF17915041C0507C2362602D4DC0210F0B1E915041C0FF97D75C602D4DC0996FD724915041C0ADF38B57602D4DC01B39E32A915041C05B4F4052602D4DC0A002EF30915041C0897EB84D602D4DC099F8FA36915041C004996C48602D4DC079E4CA3D915041C05EAC2643602D4DC047AFD643915041C00508DB3D602D4DC0C978E249915041C0AC638F38602D4DC04A42EE4F915041C04D7F4333602D4DC0BCA2BA56915041C0F0DAF72D602D4DC03D6CC65C915041C0150A7029602D4DC03562D262915041C019662424602D4DC03BFDDC68915041C00139DE1E602D4DC0718DAA6F915041C09D949219602D4DC0EF56B675915041C00BEF4614602D4DC0D8ABC57B915041C0074BFB0E602D4DC0DA46D081915041C0FEAFB309602D4DC0BED69D88915041C053952705602D4DC0BACBA98E915041C0FCA8E1FF5F2D4DC00968B494915041C0910496FA5F2D4DC08231C09A915041C0BA1F4AF55F2D4DC06BC08DA1915041C0AD7BFEEF5F2D4DC06A5B98A7915041C03DD7B2EA5F2D4DC0E524A4AD915041C08F7C6BE55F2D4DC058EFAFB3915041C0AD60DFE05F2D4DC0BC6FBFB9915041C0F8C597DB5F2D4DC020D18BC0915041C082214CD65F2D4DC0999A97C6915041C0077D00D15F2D4DC01164A3CC915041C0A390BACB5F2D4DC05A00AED2915041C0BFAB6EC65F2D4DC03B8F7BD9915041C0400723C15F2D4DC0B15887DF915041C0E6EC96BC5F2D4DC0321F92E5915041C02A924FB75F2D4DC09EE99DEB915041C03EAD03B25F2D4DC07F786BF2915041C08D07B8AC5F2D4DC05DCD7AF8915041C01E1B72A75F2D4DC0A56985FE915041C0977626A25F2D4DC019339104925041C0A391DA9C5F2D4DC0F8C15E0B925041C004C152985F2D4DC069896911925041C0771C07935F2D4DC0DD527517925041C0EC77BB8D5F2D4DC04E1C811D925041C057936F885F2D4DC0B27C4D24925041C078A629835F2D4DC07047592A925041C0E501DE7D5F2D4DC0DE106530925041C0535D92785F2D4DC04FDA7036925041C08A7746735F2D4DC019C6403D925041C07BA6BE6E5F2D4DC005BC4C43925041C0E50173695F2D4DC072855849925041C0FB142D645F2D4DC02D50644F925041C05B30E15E5F2D4DC08DB03056925041C0BC8B95595F2D4DC0FA793C5C925041C01DE749545F2D4DC066434862925041C06D16C24F5F2D4DC0D40A5368925041C06031764A5F2D4DC0AB99206F925041C0BB8C2A455F2D4DC017632C75925041C09D9EE43F5F2D4DC038B93B7B925041C05AFA983A5F2D4DC028544681925041C074164D355F2D4DC095571088925041C064BA05305F2D4DC061AD1F8E925041C01D16BA2A5F2D4DC04F482A94925041C035FB2D265F2D4DC03B3D369A925041C08856E2205F2D4DC0A20642A0925041C097BB9A1B5F2D4DC0F5670EA7925041C0E4164F165F2D4DC05E311AAD925041C0327203115F2D4DC0C2FA25B3925041C09585BD0B5F2D4DC0FB9630B9925041C070A071065F2D4DC0CD25FEBF925041C08085E5015F2D4DC0B61A0AC6925041C060299EFC5E2D4DC07F7019CC925041C00A8552F75E2D4DC06A0B24D2925041C0E29F06F25E2D4DC0359AF1D8925041C025FBBAEC5E2D4DC09C63FDDE925041C07D0E75E75E2D4DC0D2FF07E5925041C0BC6929E25E2D4DC032C913EB925041C0530E9DDD5E2D4DC08383E1F1925041C0B9B355D85E2D4DC0651FECF7925041C0F30E0AD35E2D4DC0C6E8F7FD925041C02C6ABECD5E2D4DC026B20304935041C07D3B78C85E2D4DC0A7CDD40A935041C015972CC35E2D4DC08F68DF10935041C04BF2E0BD5E2D4DC0EE31EB16935041C045D754B95E2D4DC0CF26F71C935041C0343C0DB45E2D4DC01A88C323935041C06597C1AE5E2D4DC07751CF29935041C0692635A75E2D4DC0C0B91E32935041C0DA38AAA25E2D4DC05E74EC38935041C09467229E5E2D4DC0396AF83E935041C0D57897995E2D4DC041B0C945935041C07F670F955E2D4DC00C3D964C935041C05BBA84905E2D4DC04032A252935041C03C1F3D8B5E2D4DC086936E59935041C0B8C3B0865E2D4DC0D04D3C60935041C054602A825E2D4DC0F9434866935041C034059E7D5E2D4DC0CACF146D935041C0CCA117795E2D4DC0F4C52073935041C044468B745E2D4DC03E80EE79935041C054613F6F5E2D4DC087E0BA80935041C0ECFDB86A5E2D4DC0B0D6C686935041C02EA12C665E2D4DC0641C988D935041C0273EA6615E2D4DC010E4A293935041C096E2195D5E2D4DC0589E709A935041C01B3F93585E2D4DC0732B3DA1935041C02D9A47535E2D4DC0C5F448A7935041C05E88BF4E5E2D4DC005B016AE935041C089DB344A5E2D4DC0BB7621B4935041C0B6C9AC455E2D4DC0F831EFBA935041C009DC21415E2D4DC08FECBCC1935041C077099A3C5E2D4DC0CB6DCCC7935041C0A4254E375E2D4DC0A64295CE935041C06378C3325E2D4DC0D237A1D4935041C0BE653B2E5E2D4DC0015071DB935041C00C78B0295E2D4DC0970A3FE2935041C0A0A628255E2D4DC067004BE8935041C04DB99D205E2D4DC0828C17EF935041C0A21D561B5E2D4DC0371CE5F5935041C06C02CA165E2D4DC00C11F1FB935041C0DB5E43125E2D4DC0229EBD02945041C0A343B70D5E2D4DC0F792C908945041C07D9E30095E2D4DC0EED99A0F945041C03543A4045E2D4DC0B6656716945041C0DE555EFF5D2D4DC04E30731C945041C031FAD1FA5D2D4DC08EEA4023945041C006974BF65D2D4DC035B24B29945041C0553BBFF15D2D4DC0726C1930945041C0B69738ED5D2D4DC086F9E536945041C0747CACE85D2D4DC056EEF13C945041C06FD825E45D2D4DC0E1A9BF43945041C0C233DADE5D2D4DC0B344CA49945041C008D84DDA5D2D4DC0EFFE9750945041C0E6C4C5D55D2D4DC08F456957945041C0EB173BD15D2D4DC0380C745D945041C0F205B3CC5D2D4DC06FC74164945041C0945828C85D2D4DC091BC4D6A945041C02FBDE0C25D2D4DC0C31D1A71945041C06C6154BE5D2D4DC000D8E777945041C0CEFDCDB95D2D4DC01ACEF37D945041C06CA241B55D2D4DC0DC59C084945041C057FEBAB05D2D4DC061158E8B945041C0879934AC5D2D4DC0E5969D91945041C053B4E8A65D2D4DC01FF76998945041C0FA985CA25D2D4DC0EAEB759E945041C0E0F4D59D5D2D4DC070A743A5945041C0779949995D2D4DC02D3310AC945041C0CD35C3945D2D4DC044291CB2945041C060DA36905D2D4DC003B5E8B8945041C03335EB8A5D2D4DC0457EF4BE945041C0109164865D2D4DC0C739C2C5945041C0657FDC815D2D4DC07FC68ECC945041C0EED1517D5D2D4DC09CBB9AD2945041C0AABEC9785D2D4DC036026CD9945041C098113F745D2D4DC0D7C876DF945041C0EE2BF36E5D2D4DC0825744E6945041C0D5196B6A5D2D4DC0B21212ED945041C0BE6CE0655D2D4DC053D91CF3945041C0A35A58615D2D4DC08094EAF9945041C022ADCD5C5D2D4DC09989F6FF945041C0689B45585D2D4DC04D16C306955041C0B4B5F9525D2D4DC0F6A4900D955041C0C850734E5D2D4DC07326A013955041C074F6E6495D2D4DC0C326691A955041C03B5260455D2D4DC03FE23621955041C09835D4405D2D4DC06E624627955041C0C5914D3C5D2D4DC071EF122E955041C07AEC01375D2D4DC0AFB81E34955041C0B6DA79325D2D4DC05D45EB3A955041C0B3ECEE2D5D2D4DC0E1FFB841955041C0FC1A67295D2D4DC09BF5C447955041C05B2DDC245D2D4DC0A481914E955041C0A25B54205D2D4DC062779D54955041C0AB74081B5D2D4DC072916E5B955041C007877D165D2D4DC0781D3B62955041C048B5F5115D2D4DC032134768955041C03BC76A0D5D2D4DC0B2CD146F955041C0DFF5E2085D2D4DC0F3941F75955041C0CF0758045D2D4DC0714FED7B955041C0FBF5CFFF5C2D4DC01DDCB982955041C09C5084FA5C2D4DC054A5C588955041C04CACFDF55C2D4DC0CA60938F955041C0269171F15C2D4DC011279E95955041C0D2ECEAEC5C2D4DC087E26B9C955041C0CC905EE85C2D4DC0B29C39A3955041C0BF2BD8E35C2D4DC0251E49A9955041C048468CDE5C2D4DC04C7E15B0955041C0EFA105DA5C2D4DC0C139E3B6955041C0BE8679D55C2D4DC00500EEBC955041C064E2F2D05C2D4DC079BBBBC3955041C0CDC666CC5C2D4DC036B0C7C9955041C0D322E0C75C2D4DC0323D94D0955041C0EB3C94C25C2D4DC0CCCB61D7955041C0512108BE5C2D4DC089C06DDD955041C0257C81B95C2D4DC0ECD83DE4955041C08560F5B45C2D4DC0A6CD49EA955041C01FBC6EB05C2D4DC0178917F1955041C06960E2AB5C2D4DC0C414E4F7955041C0BA049BA65C2D4DC0EDDEEFFD955041C0891610A25C2D4DC06399BD04965041C00E45889D5C2D4DC09C60C80A965041C0DB56FD985C2D4DC0121B9611965041C0E44475945C2D4DC0B5A76218965041C02897EA8F5C2D4DC0C09C6E1E965041C02FB19E8A5C2D4DC0572B3C25965041C01ADE16865C2D4DC072AC4B2B965041C0093A90815C2D4DC067391832965041C0E2DD037D5C2D4DC088F3E538965041C0487A7D785C2D4DC012BBF03E965041C01D1EF1735C2D4DC03375BE45965041C01938A56E5C2D4DC0C8038C4C965041C07BD41E6A5C2D4DC04ECB9652965041C04D7892655C2D4DC06E856459965041C045140C615C2D4DC06D7B705F965041C04BB77F5C5C2D4DC07E924066965041C0F813F9575C2D4DC07FC20A6D965041C0376DAD525C2D4DC011171A73965041C02C5B254E5C2D4DC0B0A3E679965041C059AD9A495C2D4DC0B598F27F965041C0E49A12455C2D4DC0CA53C086965041C0FBAC87405C2D4DC0C2DF8C8D965041C0FCDAFF3B5C2D4DC06CD59893965041C04CF5B3365C2D4DC08335659A965041C038912D325C2D4DC0802B71A0965041C0F634A12D5C2D4DC09AE53EA7965041C0398F1A295C2D4DC06B2C10AE965041C0D4738E245C2D4DC0A1F21AB4965041C042CF07205C2D4DC008AEE8BA965041C09D29BC1A5C2D4DC02A77F4C0965041C06A8535165C2D4DC01704C1C7965041C02129A9115C2D4DC02FBE8ECE965041C067C5220D5C2D4DC0AF8599D4965041C01A6996085C2D4DC0CA3F67DB965041C0E3C40F045C2D4DC0B5CC33E2965041C00EA983FF5B2D4DC05FC13FE8965041C0E4C237FA5B2D4DC0E94F0DEF965041C08F5DB1F55B2D4DC04CD11CF5965041C0A00125F15B2D4DC0EA5CE9FB965041C0FE5C9EEC5B2D4DC04E18B702975041C0214112E85B2D4DC0F50CC308975041C019A5CAE25B2D4DC0FF6D8F0F975041C029F73FDE5B2D4DC0FB629B15975041C0F7E4B7D95B2D4DC091EF671C975041C087F62CD55B2D4DC0F8A93523975041C06824A5D05B2D4DC0999F4129975041C0D9C618CC5B2D4DC017E51230975041C00C6392C75B2D4DC093AC1D36975041C0CF7C46C25B2D4DC01A3BEB3C975041C081D8BFBD5B2D4DC0FFC7B743975041C098BC33B95B2D4DC0A5BCC349975041C0E217ADB45B2D4DC005789150975041C05BFC20B05B2D4DC0313E9C56975041C0A3579AAB5B2D4DC08DF9695D975041C05B714EA65B2D4DC012883764975041C0CF55C2A15B2D4DC03C4E426A975041C013B13B9D5B2D4DC09A091071975041C07453AF985B2D4DC0134FE177975041C096EF28945B2D4DC08A16EC7D975041C024939C8F5B2D4DC099D0B984975041C01537558A5B2D4DC0A79AC58A975041C0F148CA855B2D4DC08E269291975041C0403642815B2D4DC097E15F98975041C09688B77C5B2D4DC013A86A9E975041C0E1752F785B2D4DC01B6338A5975041C0CDC7A4735B2D4DC00C5844AB975041C048E0586E5B2D4DC0F67115B2975041C0F2CDD0695B2D4DC081FEE1B8975041C0DB1F46655B2D4DC074F3EDBE975041C0830DBE605B2D4DC00080BAC5975041C06C5F335C5B2D4DC0F474C6CB975041C0AB4CAB575B2D4DC0F62F94D2975041C0AE665F525B2D4DC0FA8F60D9975041C05602D94D5B2D4DC0E2856CDF975041C0CCA54C495B2D4DC0ED3F3AE6975041C0D841C6445B2D4DC05E0745EC975041C04DE539405B2D4DC066C112F3975041C0433FB33B5B2D4DC02708E4F9975041C0972327375B2D4DC049CEEEFF975041C0ED86DF315B2D4DC0BB5DBC06985041C0AE98542D5B2D4DC09EE9880D985041C05EC6CC285B2D4DC032DF9413985041C0B5D741245B2D4DC08B99621A985041C0C805BA1F5B2D4DC0A7606D20985041C0511F6E1A5B2D4DC01EEF3A27985041C0A530E3155B2D4DC075A9082E985041C0B25E5B115B2D4DC08E701334985041C00570D00C5B2D4DC0E62AE13A985041C0AD9D48085B2D4DC07720ED40985041C02EAEBD035B2D4DC0C237BD47985041C0569B35FF5A2D4DC0BCF28A4E985041C053F5E9F95A2D4DC0C6BB9654985041C0C65063F55A2D4DC09B48635B985041C0A034D7F05A2D4DC0323D6F61985041C0AD8F50EC5A2D4DC083F83C68985041C01BEBC9E75A2D4DC05585096F985041C010457EE25A2D4DC05C4E1575985041C038E7F1DD5A2D4DC0C893E67B985041C024836BD95A2D4DC0305BF181985041C07526DFD45A2D4DC03015BF88985041C0778158D05A2D4DC07CD08C8F985041C0AB65CCCB5A2D4DC097969795985041C0ADC045C75A2D4DC0E451659C985041C07CDAF9C15A2D4DC0DAB131A3985041C00E0872BD5A2D4DC065A73DA9985041C04319E7B85A2D4DC0B7610BB0985041C035475FB45A2D4DC0C82816B6985041C06A58D4AF5A2D4DC01AE3E3BC985041C045444CAB5A2D4DC07A29B5C3985041C08D9E00A65A2D4DC002C4BFC9985041C0BCAF75A15A2D4DC0527E8DD0985041C043DDED9C5A2D4DC0DB7399D6985041C0D3EE62985A2D4DC0B1FF65DD985041C0D5DBDA935A2D4DC0A5BA33E4985041C07F2D508F5A2D4DC088AF3FEA985041C00391088A5A2D4DC073100CF1985041C0BE747C855A2D4DC0FF0418F7985041C079CEF5805A2D4DC0B04BE9FD985041C01572697C5A2D4DC030D7B504995041C07B0DE3775A2D4DC00BCDC10A995041C0B1B056735A2D4DC002878F11995041C0AC540F6E5A2D4DC080229A17995041C0C76584695A2D4DC0CADC671E995041C02153FC645A2D4DC042693425995041C0BEA471605A2D4DC0215E402B995041C0AE91E95B5A2D4DC011190E32995041C029A35E575A2D4DC0E0A4DA38995041C0F4FC12525A2D4DC0DA6DE63E995041C0B1E88A4D5A2D4DC034B4B745995041C0483A00495A2D4DC010A9C34B995041C0952778445A2D4DC086359052995041C0A638ED3F5A2D4DC0CDEF5D59995041C07466653B5A2D4DC0D8B6685F995041C08077DA365A2D4DC01D713666995041C0031B93315A2D4DC00D3B426C995041C086BE062D5A2D4DC087C60E73995041C0531980285A2D4DC0C781DC79995041C0C1FBF3235A2D4DC0B801EC7F995041C020586D1F5A2D4DC01503B586995041C0D6B1211A5A2D4DC006CCC08C995041C0700B9B155A2D4DC0AE129293995041C0ECAE0E115A2D4DC0279E5E9A995041C0314A880C5A2D4DC0F9936AA0995041C0AAEDFB075A2D4DC0701F37A7995041C0EF8875035A2D4DC0401543AD995041C0FE2BE9FE592D4DC030CF10B4995041C089459DF9592D4DC0142FDDBA995041C0CBE016F5592D4DC0E524E9C0995041C0D4838AF0592D4DC0D1DEB6C7995041C0C6DD03EC592D4DC0FEF686CE995041C051C177E7592D4DC080EB92D4995041C0382430E2592D4DC0D47A60DB995041C01076A5DD592D4DC02F416BE1995041C0D9621DD9592D4DC015FC38E8995041C0C67392D4592D4DC055B606EF995041C076A10AD0592D4DC0567D11F5995041C075447ECB592D4DC04137DFFB995041C0A7DFF7C6592D4DC00D2DEB019A5041C020F9ABC1592D4DC0EC8CB7089A5041C0CC5325BD592D4DC02248850F9A5041C01C3699B8592D4DC00BC894159A5041C0299112B4592D4DC0CA54611C9A5041C0A47486AF592D4DC048496D229A5041C0B1CFFFAA592D4DC003D639299A5041C0BAE8B3A5592D4DC0596407309A5041C031CC27A1592D4DC0D65813369A5041C03727A19C592D4DC091E5DF3C9A5041C071541998592D4DC006DBEB429A5041C04B658E93592D4DC04095B9499A5041C03251068F592D4DC011AD89509A5041C0B8AABA89592D4DC0F97595569A5041C08EBB2F85592D4DC03230635D9A5041C09EA8A780592D4DC098BC2F649A5041C0F6F91C7C592D4DC066B13B6A9A5041C0A0E69477592D4DC0446C09719A5041C05A380A73592D4DC0973214779A5041C0199BC26D592D4DC0DFC1E17D9A5041C05C3E3669592D4DC04B4DAE849A5041C072D9AF64592D4DC00F43BA8A9A5041C04F7C2360592D4DC0F1FC87919A5041C036169D5B592D4DC0227E97979A5041C073B91057592D4DC08909649E9A5041C0158ACA51592D4DC0259931A59A5041C0746D3E4D592D4DC0998D3DAB9A5041C05FC8B748592D4DC04D1A0AB29A5041C0B9AB2B44592D4DC0C50E16B89A5041C0A306A53F592D4DC0789BE2BE9A5041C073A9183B592D4DC05855B0C59A5041C08FD69036592D4DC0C64ABCCB9A5041C0965C4631592D4DC054368CD29A5041C0E93FBA2C592D4DC0CA2A98D89A5041C07A2C3228592D4DC0A0E565DF9A5041C0923DA723592D4DC05B7132E69A5041C0AB6A1F1F592D4DC0C7663EEC9A5041C08483D319592D4DC00DF50BF39A5041C05FDE4C15592D4DC0BE81D8F99A5041C0ACC1C010592D4DC03076E4FF9A5041C0851C3A0C592D4DC0E002B1069B5041C0CCFFAD07592D4DC051F7BC0C9B5041C03F5A2703592D4DC079B28A139B5041C0CFFB9AFE582D4DC0BFF75B1A9B5041C0400D55F9582D4DC06D9366209B5041C0F9AFC8F4582D4DC0474D34279B5041C0EE4A42F0582D4DC00543402D9B5041C009EEB5EB582D4DC065CE0C349B5041C071482FE7582D4DC08B89DA3A9B5041C028A2E3E1582D4DC0E823E5409B5041C0DA4457DD582D4DC0C2DDB2479B5041C0C7DFD0D8582D4DC07ED3BE4D9B5041C0DD8244D4582D4DC0DB5E8B549B5041C040DDBDCF582D4DC0FE19595B9B5041C045BF31CB582D4DC0D49968619B5041C0091AABC6582D4DC0822635689B5041C051735FC1582D4DC055EF406E9B5041C0BE5FD7BC582D4DC025AA0E759B5041C0B8704CB8582D4DC0D435DB7B9B5041C0AE9DC4B3582D4DC03A2BE7819B5041C0A2AE39AF582D4DC0E8B6B3889B5041C00C9BB1AA582D4DC0B771818F9B5041C049F465A5582D4DC0883A8D959B5041C0A703DBA0582D4DC019805E9C9B5041C0FC30539C582D4DC0044769A29B5041C08341C897582D4DC02C0137A99B5041C04C2E4093582D4DC07D8D03B09B5041C05C7FB58E582D4DC038820FB69B5041C0CDE16D89582D4DC06C11DDBC9B5041C053C5E184582D4DC05BD7E7C29B5041C09B1F5B80582D4DC07792B5C99B5041C02EC2CE7B582D4DC0494C83D09B5041C0655D4877582D4DC083138ED69B5041C0F7FFBB72582D4DC055CD5BDD9B5041C0B8A1746D582D4DC084226BE39B5041C099B2E968582D4DC02EAE37EA9B5041C0E99E6164582D4DC0F96805F19B5041C0EFEFD65F582D4DC0AE5D11F79B5041C0A4DC4E5B582D4DC0FDE9DDFD9B5041C0A52DC456582D4DC0B4DEE9039C5041C09F467851582D4DC06F3EB60A9C5041C0EB32F04C582D4DC038F983119C5041C0E5836548582D4DC0EBED8F179C5041C0026FDD43582D4DC01C34611E9C5041C099C9563F582D4DC0BDC02D259C5041C0A6ACCA3A582D4DC01FB5392B9C5041C03C074436582D4DC0BD4106329C5041C05360F830582D4DC0870A12389C5041C082BA712C582D4DC09DC5DF3E9C5041C05F5DE527582D4DC0F050AC459C5041C017F85E23582D4DC09C46B84B9C5041C08D9AD21E582D4DC0640086529C5041C002F48619582D4DC0B39A90589C5041C0284E0015582D4DC0C8555E5F9C5041C06CEF7310582D4DC0F99A2F669C5041C0828AED0B582D4DC02C623A6C9C5041C0F12C6107582D4DC0F21B08739C5041C09EC7DA02582D4DC09D1114799C5041C0706A4EFE572D4DC0EA9CE07F9C5041C0B0CC06F9572D4DC0132CAE869C5041C0931D7CF4572D4DC0C120BA8C9C5041C0240AF4EF572D4DC008AD86939C5041C0055B69EB572D4DC0B6A192999C5041C09547E1E6572D4DC0FB2D5FA09C5041C0781F95E1572D4DC09281EEA79C5041C03612234B572D4DC0AEFD0C779D5041C0BF1003C3562D4DC07C67764B9E5041C0422F7261562D4DC0712E3AED9E5041C03662B9E7552D4DC01A6648949F5041C04AD43B70552D4DC0B09E8E56A05041C01B3BBBF8542D4DC0D4E8E821A15041C0EBC0E372542D4DC0B34078E9A15041C0E17385EE532D4DC05CF5CFD3A25041C03EAE475A532D4DC05C1EB8C5A35041C0036534D8522D4DC03DDD2FA0A45041C0383B625B522D4DC05178FD82A55041C0FBCB6ECF512D4DC0681E7F82A65041C05D7F934F512D4DC0203BA470A75041C02FFC6EAB502D4DC07F45889DA85041C00C5D490D502D4DC05F4905D8A95041C0B066085D4F2D4DC0441EC111AB5041C0F6074CB14E2D4DC097F39757AC5041C046E82FFA4D2D4DC00AE3FBC3AD5041C0F43B1D814D2D4DC069344EC7AE5041C0F2B388EA4C2D4DC068DC1EEBAF5041C01FE05D654C2D4DC069854CFBB05041C0C17B88D54B2D4DC02E0D2C44B25041C08C332B3E4B2D4DC0E74D1390B35041C00A37EA584A2D4DC0C8D1E751B55041C01A632C9D492D4DC0F5B8BE10B75041C0D670D3CD482D4DC0E81DADBFB85041C0669E6A20482D4DC0D399BF7ABA5041C058B1868A472D4DC0C3B29BDFBB5041C0558D5DDF462D4DC041054BA8BD5041C03F3E7649462D4DC0784FFF16BF5041C094FC5FBD452D4DC0FA669F7CC05041C0FA5B004B452D4DC02A297CBFC15041C0E12A1EBE442D4DC08580A345C35041C072BDCE22442D4DC088328B0AC55041C00033ADAC432D4DC05E305444C65041C031688D10432D4DC0C7AF2A3BC85041C0FDEC9196422D4DC056E1DBA6C95041C0BD779200422D4DC0E56DA85CCB5041C01399A76A412D4DC0F055A4D0CC5041C0140845CC402D4DC08C4030C2CE5041C00444D9582F2D4DC01BF03D3C015141C0DA013C742E2D4DC08534A00B015141C09BAD33AF2D2D4DC0B0BD4F6C035141C08C4679882E2D4DC0971A9AB3035141C09CA968BA2D2D4DC0BD913A0E065141C09273F6CB2C2D4DC0752DA5E0055141C068DF44092C2D4DC07FF1F716085141C06AF391E82C2D4DC076D03D5B085141C08CB0814F2C2D4DC095A1C52D0A5141C020C28C5C2B2D4DC0183CDFFA095141C01E217A912A2D4DC0A64F27660C5141C0A9EB406C2B2D4DC0D7B3EFAB0C5141C024454A0A272D4DC006026536195141C0E61D649F282D4DC06E4A35311E5141C0F05CC616372D4DC0551BCB4C4D5141C0343CEB34372D4DC073EC556D4D5141C07DC7CB613F2D4DC0B59ECE625F5141C01064E12A542D4DC01EE394D0795141C04C6CDBA7572D4DC06944B2B47B5141C0E84CB2D1912D4DC0AEDB72DD9A5141C004006417A62D4DC021EDE5DFB15141C0B34CB529B02D4DC09623D43FBD5141C075A911AFD32D4DC06DB35E30D25141C0890296E61F2E4DC025C001B5D15141C088A8CDDE382E4DC062FFA37DD85141C03F3CC518432E4DC032452E04E85141C062A50F0D422E4DC0531F4AAFE95141C07DC69BE2442E4DC0FEC4A8FFE85141C085CFF099AA2E4DC0677D2D693F5141C04894CEBDBF2E4DC0E82984731F5141C0784F46A42E2E4DC01080BBCFE55041C04C0593BA602D4DC0D6973DB4905041C0","BOCA",3552.49956454,772617.408713,14884,7563,7321,4,48
54,"0106000020E610000001000000010300000001000000B1030000E1B5808D512E4DC0D4AC247DD94F41C02847D58F362E4DC07752EE7DEB4F41C07A1CF65A362E4DC04996E49CEB4F41C09A922E32362E4DC0EE90A1BCEB4F41C05305E30A362E4DC0FEFB2FE6EB4F41C0933C08DC352E4DC08B4EE721EC4F41C064DF98C7352E4DC047EC0750EC4F41C0FF2AF1B9352E4DC087B52E81EC4F41C07ED160B5352E4DC01AA2BEA7EC4F41C01E4691B7352E4DC0EE1848E7EC4F41C0ECC0DBCB352E4DC07A348A21ED4F41C09003E9DA352E4DC003519E46ED4F41C0BD2B84F4352E4DC0191ECB77ED4F41C005709BD73D2E4DC0F27BD9AAF54F41C02C11F3C93B2E4DC04454AD11F74F41C07171D59D2D2E4DC020854B31005041C0EE227CC78B2D4DC0B3389D5A685041C0357D5A6E8B2D4DC0DDE3D99D685041C04D1342F98A2D4DC0D1D7F7F3685041C002E3930A8A2D4DC0B29BE197695041C043F8812C892D4DC0E40FF82E6A5041C0A656475E882D4DC0F130D6C96A5041C09E16956F872D4DC06A41DC796B5041C0F55FA95F862D4DC054E8FB386C5041C039E3829D852D4DC09B2B59D26C5041C0617580C5842D4DC04F1028676D5041C0C89DBAAE832D4DC0907C46456E5041C0AD794BC2822D4DC01585DDFC6E5041C051004512822D4DC0EF256A8C6F5041C03F707336812D4DC05205D82E705041C0066E6B86802D4DC0BF13EEC2705041C03AF87FE27F2D4DC02A10E144715041C009DEFD557F2D4DC036C071B5715041C06D09028A7E2D4DC0B3453460725041C04C5CFE957D2D4DC04A67E926735041C06910E6DC7C2D4DC05B9848C0735041C03E21011D7C2D4DC0D6523A61745041C048E248977B2D4DC03BA603CE745041C012AEFFE47A2D4DC072C32365755041C0883603197A2D4DC040396611765041C046921A15792D4DC0B19728FD765041C01AAA5567782D4DC0D0264694775041C04C6F7988772D4DC0EB875C4A785041C01B27489E762D4DC00A1A3F07795041C01D354EFA752D4DC08C4E4CB4795041C053C71616752D4DC03BFD539F7A5041C0BFDA0185742D4DC02B699D297B5041C0A65A1306742D4DC0C31608A47B5041C09D593B4F732D4DC0CCE1BF487C5041C08F25A39A722D4DC0710F18FB7C5041C0A2538BC2712D4DC0AB4FD3C17D5041C016BAB164702D4DC095C455117F5041C02BF805A76F2D4DC04DBECBD27F5041C02873F5F66E2D4DC0575E147F805041C01203CB7E6E2D4DC09F0D1E07815041C0E4F31E056E2D4DC0D42CDC89815041C00E37D3776D2D4DC0E96E6313825041C011B7B4A26C2D4DC0A1D0ADFD825041C0E75B4AE46B2D4DC0E10A93B7835041C0BDC0260C6B2D4DC08E3816A1845041C0FA05F16E6A2D4DC0413CF151855041C02489D1DA692D4DC07C2333F8855041C0C2D6AB21692D4DC0BA8326B8865041C07F346DA0682D4DC041F85A55875041C02D3D97F2672D4DC01655671E885041C07DA8914B672D4DC04E9586D4885041C0F1B514A9662D4DC03066AA8A895041C0328ED60B662D4DC0DAE879548A5041C02B8141DF652D4DC02D435B868A5041C07DDEF5D9652D4DC02E0D678C8A5041C080F3AFD4652D4DC07CD872928A5041C0355164CF652D4DC005747D988A5041C0366E18CA652D4DC072034B9F8A5041C082CBCCC4652D4DC071CD56A58A5041C006FB44C0652D4DC0434F66AB8A5041C0B458F9BA652D4DC0CAEA70B18A5041C0FCB5ADB5652D4DC0C6B47CB78A5041C0A68A67B0652D4DC080454ABE8A5041C050E81BAB652D4DC002E154C48A5041C09545D0A5652D4DC001AB60CA8A5041C03A7648A1652D4DC065A16CD08A5041C09293FC9B652D4DC0550239D78A5041C0D3F0B096652D4DC050CC44DD8A5041C0104E6591652D4DC04D9650E38A5041C0CE611F8C652D4DC0FFEC5FE98A5041C04D80D386652D4DC080C228F08A5041C087DD8781652D4DC07D8C34F68A5041C090393C7C652D4DC0E0E143FC8A5041C02B6AB477652D4DC043D84F028B5041C076876872652D4DC02F391C098B5041C05A9C226D652D4DC07304280F8B5041C08BF9D667652D4DC06BCE33158B5041C020578B62652D4DC0E9693E1B8B5041C0FF733F5D652D4DC04DF90B228B5041C02AD1F357652D4DC043C317288B5041C021026C53652D4DC0288B222E8B5041C04A5F204E652D4DC01C552E348B5041C0A532DA48652D4DC03671FF3A8B5041C0CD8F8E43652D4DC02A3B0B418B5041C056ED423E652D4DC0A6D615478B5041C03E94FB38652D4DC092A1214D8B5041C011B1AF33652D4DC0F130EF538B5041C03898232F652D4DC0DAF7F9598B5041C01C3FDC29652D4DC0C7C205608B5041C0399C9024652D4DC0B98C11668B5041C069B9441F652D4DC09DEDDD6C8B5041C08216F919652D4DC08EB7E9728B5041C04B2BB314652D4DC0CB82F5788B5041C03487670F652D4DC024D8047F8B5041C0012EDB0A652D4DC07764D1858B5041C0DBD49305652D4DC0612FDD8B8B5041C0EE314800652D4DC04FF9E8918B5041C0628FFCFA642D4DC0C494F3978B5041C071ECB0F5642D4DC0B15EFF9D8B5041C0E0C06AF0642D4DC056EFCCA48B5041C04F1E1FEB642D4DC0CA8AD7AA8B5041C0FE0493E6642D4DC02880E3B08B5041C0CCAB4BE1642D4DC00C4BEFB68B5041C056C7FFDB642D4DC0CF65C0BD8B5041C0C024B4D6642D4DC04301CBC38B5041C075396ED1642D4DC076CCD6C98B5041C0779622CC642D4DC06096E2CF8B5041C08BB3D6C6642D4DC03DF7AED68B5041C0F7E34EC2642D4DC090EDBADC8B5041C0F44003BD642D4DC079B7C6E28B5041C0F19DB7B7642D4DC06181D2E88B5041C0FDBA6BB2642D4DC03CE29EEF8B5041C0A9CF25AD642D4DC06FADAAF58B5041C0A12CDAA7642D4DC05477B6FB8B5041C06A888EA2642D4DC0A6CCC5018C5041C06FA5429D642D4DC07E2D92088C5041C0CFD5BA98642D4DC0CE239E0E8C5041C0C1326F93642D4DC0B6EDA9148C5041C0DAD9278E642D4DC0198AB41A8C5041C077F6DB88642D4DC06A1982218C5041C064539083642D4DC04DE38D278C5041C0B3B0447E642D4DC0B77E982D8C5041C0F74EBE79642D4DC05575A4338C5041C08B6B7274642D4DC0A504723A8C5041C045C7266F642D4DC0F25981408C5041C0546EDF69642D4DC052F68B468C5041C038CB9364642D4DC031C0974C8C5041C0C6E7475F642D4DC07E4F65538C5041C0BCFC015A642D4DC032EC6F598C5041C044E37555642D4DC082E17B5F8C5041C020402A50642D4DC062AB87658C5041C0619DDE4A642D4DC0C646926B8C5041C0AC039745642D4DC00BD75F728C5041C087604B40642D4DC0E8A06B788C5041C031BCFF3A642D4DC02FF67A7E8C5041C01CD1B935642D4DC0DE9285848C5041C044772D31642D4DC09A4D538B8C5041C018D4E12B642D4DC075175F918C5041C0127B9A26642D4DC0D1B369978C5041C0E2D74E21642D4DC0AD7D759D8C5041C05AF4021C642D4DC0F30C43A48C5041C08E51B716642D4DC052A84DAA8C5041C009667111642D4DC0787359B08C5041C07D4CE50C642D4DC0C26865B68C5041C055699907642D4DC08CC931BD8C5041C0DF0F5202642D4DC061943DC38C5041C0756B06FD632D4DC0A2E94CC98C5041C03BC8BAF7632D4DC079B358CF8C5041C0BB9C74F2632D4DC08E1525D68C5041C07BF928ED632D4DC063DF30DC8C5041C03956DDE7632D4DC039A93CE28C5041C0A33C51E3632D4DC0819E48E88C5041C031A309DE632D4DC0430015EF8C5041C0ECFFBDD8632D4DC019CA20F58C5041C0A55C72D3632D4DC0EA932CFB8C5041C084032BCE632D4DC03E3037018D5041C0E31FDFC8632D4DC07EBF04088D5041C0307454C4632D4DC016B5100E8D5041C079190DBF632D4DC04C0B20148D5041C08D76C1B9632D4DC0A4A62A1A8D5041C0E69275B4632D4DC0E135F8208D5041C095EF29AF632D4DC0B0FF03278D5041C06B96E2A9632D4DC0019C0E2D8D5041C014F396A4632D4DC0D1651A338D5041C06A0F4B9F632D4DC00BF5E7398D5041C0D1ADC49A632D4DC022BDF23F8D5041C0780A7995632D4DC0EF86FE458D5041C01B672D90632D4DC0BE500A4C8D5041C0570CE68A632D4DC0EFA619528D5041C004299A85632D4DC0AD07E6588D5041C0A3854E80632D4DC079D1F15E8D5041C041E2027B632D4DC0489BFD648D5041C0A2807C76632D4DC05A63086B8D5041C0E79C3071632D4DC092F2D5718D5041C080F9E46B632D4DC05CBCE1778D5041C03FA09D66632D4DC0A558EC7D8D5041C0D6FC5161632D4DC06E22F8838D5041C01319065C632D4DC0A3B1C58A8D5041C02A2CC056632D4DC02208D5908D5041C0CF123452632D4DC0E7CEDF968D5041C0606FE84C632D4DC0B098EB9C8D5041C0958B9C47632D4DC0E127B9A38D5041C04C325542632D4DC027C4C3A98D5041C0D88E093D632D4DC0EF8DCFAF8D5041C064EBBD37632D4DC0B457DBB58D5041C0BD517632632D4DC065B9A7BC8D5041C0DDA5EB2D632D4DC0F3AEB3C28D5041C06202A028632D4DC0B878BFC88D5041C0ABA85823632D4DC07543CBCE8D5041C00DC40C1E632D4DC0952F9BD58D5041C08D20C118632D4DC059F9A6DB8D5041C00C7D7513632D4DC01AC3B2E18D5041C04F232E0E632D4DC0D58DBEE78D5041C07237A309632D4DC0541A8BEE8D5041C0EC935704632D4DC014E496F48D5041C02B3A10FF622D4DC0D0AEA2FA8D5041C00797C4F9622D4DC0164AAD008E5041C023B378F4622D4DC041D97A078E5041C05D5931EF622D4DC0F9A3860D8E5041C0A3B4E5E9622D4DC022F995138E5041C016095BE5622D4DC032C0A0198E5041C0EF6E13E0622D4DC056506E208E5041C05FCBC7DA622D4DC0121A7A268E5041C02F287CD5622D4DC056B5842C8E5041C09A8430D0622D4DC0137F90328E5041C0C92AE9CA622D4DC0C6499C388E5041C03B479DC5622D4DC076AA683F8E5041C0A2A351C0622D4DC0317474458E5041C06841CBBB622D4DC0B06A804B8E5041C09E9C7FB6622D4DC0D4BF8F518E5041C00BB933B1622D4DC07F205C588E5041C06A15E8AB622D4DC03AEA675E8E5041C08EBBA0A6622D4DC0ECB473648E5041C0501855A1622D4DC02B507E6A8E5041C0EE2BCA9C622D4DC0180B4C718E5041C00FD28297622D4DC0C9D557778E5041C0CB2E3792622D4DC00671627D8E5041C0238BEB8C622D4DC0BC3A6E838E5041C0E2F0A387622D4DC0D9CA3B8A8E5041C0084C5882622D4DC0F91F4B908E5041C0BDA80C7D622D4DC034BB55968E5041C01005C177622D4DC0E884619C8E5041C066623A73622D4DC0CF402FA38E5041C018BFEE6D622D4DC008DC39A98E5041C0651BA368622D4DC0B9A545AF8E5041C076C15B63622D4DC0687051B58E5041C0C7DD0F5E622D4DC009D11DBC8E5041C00F3AC458622D4DC0BC9A29C28E5041C0B7D73D54622D4DC0349135C88E5041C0FE33F24E622D4DC0E35A41CE8E5041C04850A649622D4DC087BB0DD58E5041C050F65E44622D4DC02F8619DB8E5041C08F52133F622D4DC0E04F25E18E5041C0A1ADC739622D4DC0F9A434E78E5041C0E3C97B34622D4DC09B0501EE8E5041C0E36F342F622D4DC042D00CF48E5041C0BFC3A92A622D4DC0BCC518FA8E5041C05B205E25622D4DC0EF6023008F5041C0FA851620622D4DC001F1F0068F5041C02EE2CA1A622D4DC0ACBAFC0C8F5041C0C73E7F15622D4DC0DF5507138F5041C0F99A3310622D4DC08B1F13198F5041C0EE40EC0A622D4DC02EEA1E1F8F5041C032536106622D4DC07C30F0258F5041C0C5AF1501622D4DC0ACCBFA2B8F5041C0B655CEFB612D4DC04F9606328F5041C0E0B182F6612D4DC0F75F12388F5041C00ECE36F1612D4DC093C0DE3E8F5041C0FA73EFEB612D4DC0348BEA448F5041C020D0A3E6612D4DC0DB54F64A8F5041C0AE6D1DE2612D4DC0484B02518F5041C0D589D1DC612D4DC0E2ABCE578F5041C0F5E585D7612D4DC08875DA5D8F5041C0E9403AD2612D4DC097CAE9638F5041C0069DEECC612D4DC03C94F5698F5041C0EC02A7C7612D4DC0CFF5C1708F5041C0075F5BC2612D4DC070BFCD768F5041C088FCD4BD612D4DC0DCB5D97C8F5041C0045989B8612D4DC00851E4828F5041C0BC743DB3612D4DC015E0B1898F5041C0D0D0F1AD612D4DC0B8A9BD8F8F5041C00D77AAA8612D4DC0DA45C8958F5041C01DD35EA3612D4DC07B0FD49B8F5041C0A1ED129E612D4DC0F229A5A28F5041C0178B8C99612D4DC05820B1A88F5041C08AE74094612D4DC081BBBBAE8F5041C09543F58E612D4DC02285C7B48F5041C03F5FA989612D4DC02C1495BB8F5041C071056284612D4DC04AB09FC18F5041C07761167F612D4DC0E979ABC78F5041C07CBDCA79612D4DC08643B7CD8F5041C0EE1A4475612D4DC0DED083D48F5041C0F076F86F612D4DC07B9A8FDA8F5041C0F0D2AC6A612D4DC018649BE08F5041C0C02D6165612D4DC01EB9AAE68F5041C088931960612D4DC0A41A77ED8F5041C083EFCD5A612D4DC041E482F38F5041C07E4B8255612D4DC0DAAD8EF98F5041C046E9FB50612D4DC0C47599FF8F5041C04045B04B612D4DC05C3FA505905041C0D2606446612D4DC062CE720C905041C0F0061D41612D4DC07A6A7D12905041C0E362D13B612D4DC013348918905041C0D3BE8536612D4DC0A9FD941E905041C033D93931612D4DC018186625905041C00509B22C612D4DC0ABDF702B905041C0F2646627612D4DC040A97C31905041C08E782022612D4DC024748837905041C07A94D41C612D4DC0ACD4543E905041C062F08817612D4DC03F9E6044905041C0494C3D12612D4DC0D4676C4A905041C0F1F1F50C612D4DC061327850905041C091976908612D4DC065BE4457905041C023AB2303612D4DC04389505D905041C00407D8FD602D4DC0D6525C63905041C0B6618CF8602D4DC0D2A76B69905041C0947D40F3602D4DC058083870905041C070D9F4ED602D4DC0E8D14376905041C0107FADE8602D4DC0719C4F7C905041C04DDB61E3602D4DC08B375A82905041C02B38DBDE602D4DC04FF32789905041C003948FD9602D4DC0DEBC338F905041C039F043D4602D4DC0F4573E95905041C00C4CF8CE602D4DC081214A9B905041C07767ACC9602D4DC07AB017A2905041C0720D65C4602D4DC0894C22A8905041C0FBF2D8BF602D4DC093412EAE905041C04C0593BA602D4DC0D6973DB4905041C0784F46A42E2E4DC01080BBCFE55041C04894CEBDBF2E4DC0E82984731F5141C08C061972C02E4DC08D2383BB1F5141C0670C4242DF2E4DC0C18C9ACE2C5141C0ED9785AC5F2F4DC0A9B445F8385141C0C75057FB642F4DC0BFF4439C1A5141C03548A3B3712F4DC022BD5871935041C05601F1AA492F4DC08C2B29BF6C5041C05D72DBCB2E2F4DC008F0C55A565041C04CC884E1222F4DC0837158F74B5041C09863FED51D2F4DC0870448DD475041C0FE279126192F4DC0E8B94E36465041C0886336EB192F4DC001B77880065041C00E7EADE2E82E4DC00709B944065041C032130CA5852E4DC0BD38480E045041C0B31ABA71792E4DC0221BA6A8035041C0176920316A2E4DC0DD5F59DAF24F41C0B15861AA5D2E4DC03F7AFA3EE54F41C02D81AB67552E4DC06B70B045DC4F41C02699026A522E4DC0434EEAF2D84F41C0288DB0484E2E4DC0A8096E5BD44F41C0BCD3E72B4A2E4DC0EE324ED2CF4F41C0A97FB105412E4DC0E98E11AEC54F41C02F1E5A942C2E4DC02CCC1938B04F41C022B7F2F3222E4DC0C867BE13A64F41C019359ACD162E4DC0D2BC7AAB994F41C0AE1F902A152E4DC07EA4C6FF974F41C0B96CA228FD2D4DC0A579C7307F4F41C063414ACBD82D4DC006F7712F594F41C0F6E1EB14D82D4DC0FE7BA56D584F41C064656CE0B52D4DC0FA3FDC02344F41C07CF3A544A42D4DC01437A943214F41C02E3EFB95A02D4DC0F5F360531D4F41C07AC7624E9C2D4DC09CC721DD1A4F41C072334737992D4DC09DB59C38174F41C0EEEA8D54912D4DC02ED1BAC90E4F41C0386CA0258B2D4DC0AEB32A641E4F41C0AEC694D7802D4DC0E8E99782354F41C079E70F35772D4DC0EBC9B281494F41C09819B238752D4DC01525AF6D4D4F41C020827B0A582D4DC059EF87984A4F41C05E19F346522D4DC0C9E8745F524F41C0B75DF7074D2D4DC0B4EC41944F4F41C0BC79940D402D4DC0677EAFA9484F41C09B841CE3312D4DC072B046FE4C4F41C0AAF1ABEE2F2D4DC003031FAE4F4F41C0E75688E22C2D4DC0E13532E0534F41C03789C4E12C2D4DC0C80832E0534F41C02D30E1D12C2D4DC00B0F7401544F41C01FDC4A492C2D4DC03D637A13544F41C0EFD70BEB262D4DC06594287F544F41C0761B8C06252D4DC0F2FA8EA7544F41C05C7959DA202D4DC0891879094D4F41C066632344202D4DC00E2430324D4F41C09C256957152D4DC0F2DF0124504F41C01115EE9E0B2D4DC0923899B54F4F41C0AF9B5926072D4DC035D093284D4F41C0F5843BDA022D4DC0598A10B64A4F41C0E8F830BFFC2C4DC0F531512E474F41C0CEFC43A2FF2C4DC0DCB5D32D464F41C0024987AA012D4DC0FBFF5EF4424F41C0322E18C6002D4DC0EAB61959424F41C09B9CFB9BFE2C4DC0145DB2E0404F41C0C8361702FE2C4DC0B4CFCFF8424F41C0231BBFDFFC2C4DC0ACF3A2A4444F41C08AB5A2AAF82C4DC05891F597454F41C04F99A2F7F42C4DC062E7F3A3454F41C0E9AF6883F42C4DC042135BA5454F41C0A2C726D4F42C4DC003F57AAB454F41C0002E1C39E92C4DC0B7D3D7CF4A4F41C0B35FDD73E92C4DC0023B80824F4F41C03022AC0EE62C4DC0964D8566514F41C09C33FA24E32C4DC032984E8C4D4F41C02F6FC302D22C4DC00F996F88534F41C095633CC7BE2C4DC08FC4704A554F41C099482B3BAE2C4DC0A41F317A504F41C0F3F49397952C4DC0B8998C283D4F41C05CBDD047862C4DC0D90328413A4F41C01DBCB8F8732C4DC079526645394F41C06AE38B295C2C4DC0373474C13E4F41C0D1303301562C4DC010E642AF3C4F41C01A7732B2482C4DC09EAD7C9D364F41C0A1985C652F2C4DC07895595A354F41C01A5767941B2C4DC0E4BAF9633B4F41C0251B1994192C4DC030B7A1503D4F41C0E0BC90BB1A2C4DC0DECBBB88464F41C0F40D0F0C1E2C4DC04AEF7B08504F41C019BF05042F2C4DC07A7C6FCB564F41C06960122C372C4DC0ED4E0A97584F41C0E7284400472C4DC0428015DF4D4F41C03A1DE37E512C4DC0273DC5B9464F41C01FECD754542C4DC02DFA7E53424F41C090852BD25B2C4DC0A19299AB444F41C0D372BB1F672C4DC078309DF74F4F41C0141B796E6F2C4DC0A91ED6CE5B4F41C02249A7BD6D2C4DC08E57081C6E4F41C0ACECC364692C4DC0381B4C8E7C4F41C01FE863B85C2C4DC0B6773F5E8C4F41C0E99BAF8E582C4DC09B9BB43B914F41C050E9207D5A2C4DC05B098E619D4F41C0CB2E6CE2582C4DC099FAF915A04F41C030B63006562C4DC0F1592B08A54F41C0C0896B11542C4DC0B8D37F6DA84F41C09B6DDACF522C4DC049EEE1D7AA4F41C04A9F9C28502C4DC093CEE354AF4F41C0F30CA8994F2C4DC0FFDFBD40B04F41C00A3B5CB14C2C4DC01D380E0DB34F41C0576A4BBD4B2C4DC013F6CBF8B34F41C058E5696A4A2C4DC0A56B1954B84F41C091B76EF04A2C4DC05FA3CB44BB4F41C04C29F582472C4DC00FE03402BD4F41C0A1EE6318472C4DC0FC235C61BB4F41C0D0F5ABA6472C4DC0E497731BB84F41C0EC47924F482C4DC061A05B5DB64F41C0F12F966A482C4DC05BDEC7AFB44F41C070FF92F7472C4DC0391B3E71B34F41C0BA6C60F6472C4DC008C2F49BB24F41C02326A781472C4DC0E5D311E7B14F41C0B82D7890472C4DC0D789FE94B04F41C05E4697CB472C4DC02FE52DD4AF4F41C01135A182472C4DC08287B82DAF4F41C003A27C65472C4DC0BA2BCB69AE4F41C0615227F9462C4DC018ECEB79AD4F41C0D4E1313A472C4DC0CAD6900BAD4F41C0966EACCC472C4DC014D232CFAC4F41C0EAD24ABE472C4DC0D5066CD4AA4F41C0824E9EDD482C4DC00384F836A94F41C0694F40F0482C4DC09804A4C6A74F41C0A45D3C8E482C4DC0FE740C8AA74F41C0AD81D623482C4DC0C6F0E886A74F41C027B078B3472C4DC019B52354A74F41C05E695245472C4DC0E7D3E844A74F41C04F97E1B3462C4DC04EC08FB6A64F41C0B3A2055B452C4DC0A3D745B9A64F41C0DC134795452C4DC016EB674CA64F41C07321C236462C4DC0BD445E53A64F41C026B2128F462C4DC08D09473EA64F41C051B0F159472C4DC04DFDBD9AA64F41C0F94A8792472C4DC005DBCB9AA64F41C0766C96E2472C4DC0175A8370A64F41C0B6DEF543482C4DC036A5B35DA64F41C0A8B9CFAF482C4DC011329D83A64F41C0F53E60FA482C4DC061997AE1A64F41C0379E461C492C4DC088DFB415A74F41C0DC502D66492C4DC081A70C37A74F41C08EED21DE492C4DC09260C644A74F41C078BA68334A2C4DC0EFCF5140A74F41C028CBCA8E4A2C4DC0E388FB0CA74F41C0C6F39DD94A2C4DC0BD0FDFBCA64F41C02E27A7294B2C4DC02F872397A64F41C09299979B4B2C4DC0A06B3F97A64F41C035DDEAC84B2C4DC05E4A0176A64F41C01D2853D44B2C4DC0F4634D3DA64F41C0850B7FD44B2C4DC07EE1C4C2A54F41C08CD2F3E54B2C4DC08092727CA54F41C08669A7D44B2C4DC021091152A54F41C0D481B5AC4B2C4DC0F393C130A54F41C05DBC2C2A4B2C4DC07DF63F22A54F41C0F81A4CAC4A2C4DC070C797C3A44F41C0E71D7D244B2C4DC05E33A528A44F41C0A1CC228B4B2C4DC03DA9E91EA44F41C0934FA9194C2C4DC0E8712866A44F41C073C75F584C2C4DC01B58A523A44F41C0639DD93B4C2C4DC0FE1902BCA34F41C0FB7049A14B2C4DC0A62D4E5DA34F41C0682DFE2A4B2C4DC0757F9AD9A24F41C09B7709254B2C4DC0059FDDA0A24F41C08E4974524B2C4DC0A761D23DA24F41C031204FFD4A2C4DC099357EE4A14F41C08544828D4A2C4DC0EA7ECD33A24F41C0F2E521FB492C4DC068AB8F27A24F41C078ADEC34492C4DC079F99972A14F41C0E7D15C68492C4DC0B1B1F01DA14F41C001C712254A2C4DC0E9C9C2F3A04F41C0173983854A2C4DC03D0F5065A14F41C05AD8C9E04A2C4DC0DA4D796EA14F41C046A331424B2C4DC009933844A14F41C0BC050B594B2C4DC0010F41B2A04F41C0F3BCF0DB4A2C4DC0DB51B040A04F41C08D84B71A4B2C4DC0226F96D49F4F41C026E266A94B2C4DC073789BA99F4F41C01E4358C64B2C4DC02151D6F19E4F41C0E6609A7B4C2C4DC0EC340E7F9E4F41C013696EBD4C2C4DC050F67CF89D4F41C017A9CD1F4C2C4DC037F5A7C59D4F41C048B38A934B2C4DC0E367B1809D4F41C0F6AF363E4A2C4DC0A1527B0B9C4F41C073069DDB482C4DC096424EE29B4F41C0522DB1A8472C4DC02AD2C14D9B4F41C02DC6060B472C4DC03D30102A9B4F41C0424B54A1462C4DC01B2D14559B4F41C0DF3C7856462C4DC010A221BE9B4F41C08D9F0FCA452C4DC05A864FE29B4F41C0A0D20712452C4DC0909FE4A79B4F41C08B7A4F4D442C4DC0CF7C84FD9A4F41C062B2A437442C4DC00D1FB2619A4F41C0A9DCE5C5432C4DC04675B5DB994F41C0004DD860432C4DC032BBC1AF994F41C0661876DD422C4DC0D18DDAE9994F41C08F52A492422C4DC0217F30369A4F41C0FB3EF5D3422C4DC0779607299B4F41C0DE4A4569432C4DC0045806719B4F41C08C737BDF432C4DC051E91A1F9C4F41C0EEBBCEDA432C4DC0EF1ACA8F9C4F41C033A3CF49432C4DC06218A4E69C4F41C0C858D72B432C4DC072EF733F9C4F41C0EA8578AC422C4DC06B78F5D69B4F41C0DBE1DB54422C4DC0E3C2900C9C4F41C07E935E11422C4DC06E3A7DF89C4F41C0E22F73B3422C4DC0826FCF649D4F41C0AB5AF0C6422C4DC01E936AC99D4F41C0589CBF10432C4DC0AF73D22B9E4F41C0055E4E80432C4DC0B49C9C7D9E4F41C05B82118A432C4DC0D6CF35A79E4F41C015C73439432C4DC02450D4F89E4F41C06AE53A01432C4DC0852A9B5C9F4F41C01C3A579E422C4DC0C073047A9F4F41C01A9DC27A422C4DC0AA6166C99F4F41C00A1AF687422C4DC033E122D2A04F41C0BD54FDFF412C4DC0FFFEE83EA14F41C0A52BFD8A412C4DC089073550A14F41C07C3AF75A412C4DC0FADB0C619C4F41C06A253A3F402C4DC0AD6A792C984F41C04D2C000D3D2C4DC06942D187924F41C0FF282EBD382C4DC0669599EB8D4F41C04D2ECD74322C4DC01A2B68968A4F41C0710AFD182A2C4DC05E603FDD874F41C0A64DB403272C4DC006B450C7874F41C0409B6055222C4DC0561554DB874F41C0C231F93F1F2C4DC02AB0191A884F41C0D4E0CC45192C4DC01BC3E7BD894F41C0A3BE2A33132C4DC0CAC122498C4F41C00E330D8F102C4DC09C9D18508E4F41C0D19F6C770E2C4DC049F40B0A904F41C0F9FC43D40B2C4DC002E5F48E934F41C0BA2FF8100A2C4DC02B9C92C9954F41C089A5C0E1092C4DC0EC5661D1924F41C039444CD30A2C4DC01F29FA8B904F41C0A56ED6C50A2C4DC03F69C11F8E4F41C074D3C6D80B2C4DC0A0B233658D4F41C0B026568C0D2C4DC051B8FCFA8C4F41C0529D96000F2C4DC0C81802458A4F41C0E5A4D2E2102C4DC0C1F00DE9834F41C0C5B429890F2C4DC05F397BC67B4F41C0DA25B7D60F2C4DC09D7190267A4F41C01C768D560F2C4DC05DD48FC5774F41C0A5F44ADB102C4DC077007E5A754F41C062715CE8112C4DC0C7ED2726744F41C0DD53B0F5122C4DC092E92F1D6E4F41C0AB17F22B132C4DC0FB2E76256A4F41C01ABF8D22122C4DC075AC4267654F41C0922F5719112C4DC06E2EF023604F41C0AAB282990E2C4DC0D91D3DE55D4F41C0AA7D5A800E2C4DC063DDCC715A4F41C0039BD56B0C2C4DC0979C55B3554F41C0313F6E620B2C4DC0BE681EF5504F41C021EA59B9092C4DC0AA0D156F4B4F41C090B4FE5E082C4DC044394C5D494F41C06B6C8582052C4DC0E06BE5B6464F41C0179DB829032C4DC0A38248FA424F41C07004B478FE2B4DC0D90CBE20404F41C09B5D584BFB2B4DC0D20E2AE73D4F41C0DD931AF5F62B4DC08389EE743A4F41C06E4D2AF7F22B4DC03E335604394F41C0C3204E21EE2B4DC07FA98FED374F41C00E50CFF1E92B4DC04FB38CD9354F41C00E23D758E72B4DC01E075B40304F41C0E7F32AAAE22B4DC09D55EF3A2D4F41C06B62CD11DC2B4DC053F71F382C4F41C0D3A6992AD62B4DC0ED14E4A32B4F41C0260940E2CA2B4DC021489F322B4F41C02BB64EFDC02B4DC096C970C22A4F41C08C04B922B82B4DC070A3C2512A4F41C05AB50872B32B4DC058CEFFBE2A4F41C0FCBB05DBA82B4DC0C9FF30502C4F41C0D719C9F7962B4DC04B1578982F4F41C0B2A2693C912B4DC0050D49E2304F41C0E3D9E5FD8A2B4DC0353323B82D4F41C089C732CB812B4DC06BC598D62A4F41C0FABCAFDB762B4DC027B9D3F82A4F41C096FD7B396B2B4DC02140C7AE2C4F41C06D24CDEE5F2B4DC091441D67304F41C053B660C4572B4DC06A675FFC344F41C0036F64A4502B4DC02673946D394F41C07E0405DD4D2B4DC0E9CB6FDC3A4F41C0535E58094A2B4DC03DACD0723F4F41C08803DCC4472B4DC0C2669EE7454F41C0C0A3F995472B4DC06A2A95134C4F41C0E36553ED472B4DC05C1AC186504F41C09C077B02462B4DC0022ABC67554F41C0933B2A72442B4DC0695F7D68564F41C02A9081B4422B4DC03DB29290594F41C0F899FF923F2B4DC02501C5DD5D4F41C04C0891D43D2B4DC029D12D08634F41C08F399B413C2B4DC0988CFBEB6A4F41C01006EDB8372B4DC0F9ABCAFB784F41C07C28EFB7372B4DC06D64D8907B4F41C0B2E291CD352B4DC0EE2450277F4F41C0EE4D6D5E332B4DC0818A90BA804F41C0858159BB2E2B4DC0EB21B9D4864F41C0593D8BBE2A2B4DC0D83C6A498C4F41C04820151C282B4DC0E15476BE914F41C0BDFA0207282B4DC0A5B1A695934F41C08092EC11272B4DC01F836819954F41C0931A8EE8262B4DC0FBD124B7984F41C0625CD5FD242B4DC022E7C12F9D4F41C04AD5EF2E242B4DC064949558A54F41C02498BDB8262B4DC0BC37EB00AB4F41C046FE8E59272B4DC092FB41B0AE4F41C00807217E292B4DC06D1DB7B4B24F41C0238A4D772D2B4DC023FEE0B8B64F41C0CD737885312B4DC05D452D29B94F41C08C82F242352B4DC07FEF1C7EB94F41C0110ECFFA3C2B4DC0534513C0BA4F41C0DAD941E7432B4DC0C1589916BB4F41C015514B094C2B4DC0CF56AEF9B84F41C0BB084D6A552B4DC00191FF6BB74F41C0E5E4A4E85A2B4DC0609C181CB64F41C0C8F1769D5D2B4DC0442023EAB54F41C099FF11A4602B4DC0BD064CEEB44F41C05E2687C8642B4DC04C329E59B44F41C0B068DE0F672B4DC0953EFF41B44F41C02D3DB4AB6A2B4DC071725AC2B34F41C082CDB21F6E2B4DC0093991DCB24F41C08DB4D7A0722B4DC094CB1F95B24F41C08D4A3613792B4DC09DF22686B24F41C07765DE93832B4DC0B40ABC92B44F41C03C2C6271862B4DC08DADD682B44F41C0A0F5ADA38E2B4DC0C0D9403EB54F41C048BADFD2982B4DC012C3DD40B54F41C0E1ADBDE49A2B4DC070D409DCB44F41C0B77540E29C2B4DC048293477B44F41C0ABEE46CB9E2B4DC0E80F0F67B44F41C0DFDC4DA6A32B4DC0428EABE1B34F41C0F2FD051EA62B4DC08B43FC9EB34F41C0B66E92F2A72B4DC0AA981DD2B34F41C03BE54DB8AC2B4DC031FE94CCB54F41C069A888A6B12B4DC02C89FE6EB84F41C0D4F2C34CB72B4DC095D10D6DB94F41C08A12A7E9BB2B4DC0D9CEE4A0B94F41C055189B41BF2B4DC0CA57790AB94F41C0DE4586C2C22B4DC0A3B612DCB74F41C0710AF9ABC42B4DC0BAA99D9CB64F41C0326186AAC62B4DC0B6E8F263B34F41C0DA251A3AC72B4DC0FE01D1D2B04F41C0AD33E04EC72B4DC0169293C5AF4F41C0005A382CC32B4DC0AFBDF587AD4F41C0FC859C75C22B4DC0F378E57DAB4F41C0380294BCC32B4DC005AA4EDCA84F41C0F5BAE3C5C42B4DC0A8C147ADA74F41C030939A20C62B4DC0245B64C2A64F41C05ECC7B52C72B4DC0980E6209A64F41C02A8AA73BC92B4DC005903C83A54F41C0EA307BE7CA2B4DC05F3EF3A4A54F41C00424C767CE2B4DC0C54ED01BA64F41C0CE66C207D12B4DC07E951A19A74F41C09927E15ED42B4DC0FC243EBFA84F41C03F071F99D62B4DC06D13B567A94F41C086AA2E96D82B4DC081B28C43AA4F41C0B901BCBEDC2B4DC051B75BD4AC4F41C02AEBBC83DD2B4DC0A093ECBDAE4F41C0982ADFA5E12B4DC0A4F6DA52B04F41C01AF6B611E52B4DC05541020DB14F41C0E070E9FDE62B4DC0D9F7FD8FB24F41C08A7E9D88E92B4DC017FD7D02B44F41C08012F067D32B4DC0180DDEEFC94F41C0DA5B57FDCD2B4DC0CC444107D14F41C02CAEAEBECE2B4DC035C7ABB6D64F41C0B70BC2A5C22B4DC02B1D6A9BD64F41C03C8E67CAC22B4DC0F19E642BC34F41C04F146CFE9A2B4DC02114DCF0C24F41C028AD52A6872B4DC0125A10BFC94F41C05702C420602B4DC0DB6F197EEA4F41C06A73528D532B4DC09FBC9AF5F44F41C0CDEB7A364B2B4DC0E2E389DDF64F41C0BC7355CF4A2B4DC0503DDA3DF64F41C0CB479CF83C2B4DC027BAF77AF94F41C058845A563C2B4DC072F5B090F74F41C0835869A43B2B4DC02552EE2EF74F41C033324489332B4DC0D48DC2E5F84F41C0FE9725DA2A2B4DC0720D61D7F84F41C05297094E282B4DC0F1F61220F94F41C0227B4522242B4DC096C4FBFCFA4F41C0F8BE9625232B4DC0F61AB79CFC4F41C0E494F8C5142B4DC0F440FB5E085041C077CAC5F7032B4DC08FB4F509165041C0B8FFB6FB022B4DC084B4B209165041C07DE26351002B4DC058B5735E165041C03C04331AFF2A4DC0571EED15175041C03B1A08CDFB2A4DC08E5D0EF3185041C017F9AF89F92A4DC0A710684B1C5041C068AFB816F82A4DC0E66D22651D5041C00A3C2133F82A4DC095681207205041C0025AE5FFE52A4DC0737DC19B2F5041C04C7E4AF7E52A4DC079AC7B92455041C0316304A7FB2A4DC0D2C65DA9575041C0D718D5270A2B4DC0F1F5B98A635041C0D2F62E3C082B4DC05474EF67685041C0FC6E405D082B4DC03F20F8C1685041C00795C5F30C2B4DC039C119006A5041C06F69634B0D2B4DC0E56FCBCF695041C04042D1400F2B4DC0198E1710655041C0E7E8CFDE212B4DC086445C1F6A5041C0A57E8604202B4DC046C7C4F56E5041C0C3F4F736202B4DC04EF86D3E6F5041C0EBDCD688482B4DC0D9D24E3B7A5041C02B1CEB9B4A2B4DC0B3C096E0745041C0E32A29E05C2B4DC0686964EA795041C02AB9B45B5B2B4DC05318E2527F5041C0950131E35F2B4DC0630ECF7E805041C0A8A44D36622B4DC07658406B7B5041C09E0BB98B672B4DC02D84BFC17C5041C018DA56DD692B4DC0491257987B5041C0EDA5F7616B2B4DC0155091AE775041C0FCCB64786F2B4DC004CB1B7E785041C09583D20A712B4DC0580DAFFB775041C0F60D69EB722B4DC0262D5B55765041C0175A159F742B4DC0AEEF96B4715041C0693006577C2B4DC0B90FDB245D5041C092A19A738D2B4DC09C949DBD615041C05934C4A0962B4DC039DF25ED595041C075D6F83F9A2B4DC014D0BCAC5C5041C0B2697D2E9E2B4DC042E3F72E595041C03472B4F69A2B4DC0E8338E59565041C0075400DEA72B4DC010EDA2CA4B5041C064373E7DAB2B4DC0CA4307754E5041C0222E1686AF2B4DC0AE35A5214B5041C0FF2F471AAC2B4DC0A2770337485041C01BA4BD35B92B4DC0B096A6523D5041C08B3B3FBBBC2B4DC0FF412128405041C05AF96D26BF2B4DC0352518293F5041C03934C10EC02B4DC0AE3E516A3D5041C05524300FC02B4DC02FB5903F3C5041C0330D908BBD2B4DC0D3F755FF395041C0AC7CB1CBC32B4DC07A350D2D355041C01E4DAF73CA2B4DC09949E81A2F5041C040AA5BF8CD2B4DC058D4801B325041C0D863A732D12B4DC095EB3132305041C05B0A8F68D22B4DC03EFB66DD2E5041C0D56C7095CE2B4DC00B915DB22B5041C0569295D5D42B4DC0329EE2CA265041C0F5F98580DE2B4DC09849A0A2275041C0A699C117DE2B4DC085A292612B5041C057C441BBE32B4DC0698CB2B72B5041C02480318BE42B4DC0A4509B8E285041C0F95D11A2F12B4DC0AF7F40E6295041C0228F7D39F12B4DC057D162252D5041C0CF02C9C2F62B4DC02F1DE3102F5041C0417D0E5FF72B4DC0310CFEBC2A5041C0B2B96825112C4DC0C593FD972D5041C0233FEF29142C4DC0093AF842305041C0FEFF4E51022C4DC09A9A2CBA3E5041C0C5633C65FE2B4DC0D22912A53B5041C03094B042FA2B4DC05054D0223F5041C0B8A6C3E1FD2B4DC0D343C54D425041C03B7129FCF12B4DC0FA98E91C4C5041C0DAEFC229EE2B4DC071BDD507495041C0CD004407EA2B4DC0BF81355B4C5041C05F4451A6ED2B4DC002632B864F5041C07671D125E12B4DC0C5B9F5D4595041C08D039F86DD2B4DC099407AFF565041C00257DAB1D92B4DC09BECE8525A5041C077F558EADC2B4DC0082E6C535D5041C0ED45471ED12B4DC083F2AB4D675041C04E6BDE17CD2B4DC04A916E0D645041C06968FB42C92B4DC044F663A0675041C01158C3AECC2B4DC0701923B66A5041C074407C2DC02B4DC007CF8DDA745041C0F6BE51C2BC2B4DC04FC53630725041C0F9AAAD3FBB2B4DC0F1DC00DA725041C04075896CB82B4DC037376858755041C06598DDBDBB2B4DC069414D83785041C068FCD9C4B22B4DC024C44E14805041C058BE94AAB22B4DC078341EBE815041C01F4D45E5B72B4DC03EDA7E13865041C07C02E6C2C12B4DC01F6C3EC0885041C0E418F0A5C02B4DC05B022FFF8B5041C0460DA0C8C52B4DC0D87C98EA8D5041C053430066C72B4DC086E451568A5041C0FB77EDC5D22B4DC0453FE2588D5041C007C38F75D12B4DC0EA5050D7905041C039638DDCD12B4DC086D93FEC915041C0BDB35D97D62B4DC023243218935041C0F849564FD82B4DC071891A048F5041C04E456C13E22B4DC0DBAE8370915041C00AA2DB2AED2B4DC027A65D4B885041C0BE9F1D1FF02B4DC036AA041E8A5041C0E933797EF12B4DC0A7CDACF68A5041C0591B2F84F42B4DC0B5B68D77885041C07FDDF09EF42B4DC0AA8B1E8D875041C0DDD6679AF12B4DC042C2B3CD845041C0A704B099FD2B4DC005C304137B5041C0E905E038012C4DC0BDB7AEFD7D5041C00585A45A052C4DC0A36120957A5041C0773E49BC012C4DC004C41A80775041C0BDF2CF3C0E2C4DC0DF8984306D5041C05E782D5C122C4DC0F51F985B705041C083E1342F152C4DC02BEAB71C6E5041C0EAC92CE4152C4DC0EEA751726C5041C0AAE45378122C4DC0F5F0B087695041C06323A5F01A2C4DC02A19CFCB625041C0FB629A1F292C4DC0ACE54E8C6E5041C0F02AC878302C4DC095FBBFCC685041C0733A7372582C4DC0781355D5475041C07A8B7FB2602C4DC0FB6BE0D44E5041C0CB7D03A2312C4DC00976E5A4755041C0C6429FF9342C4DC0E7401140785041C08EFE4F0E562C4DC06D26E34A5D5041C0B16D731C6C2C4DC0C447A8C74A5041C0DC691E2F732C4DC08F531C7A505041C0A8FD4146842C4DC020B8B44F5E5041C00D8FC7F0A12C4DC022A5B90D775041C0033C621CA42C4DC099A1E4C1785041C035286072A42C4DC05D8990017B5041C0BE317437992C4DC0FD400A1F7C5041C057E9FA8C992C4DC03835C3E2815041C09F0B0EC7A42C4DC04F1BE50D815041C05E1304D9A42C4DC03A8B79A4835041C0B598E7F1A42C4DC09A0AF1D1855041C094E9123FA42C4DC0C26807EA875041C0FCCD678BA32C4DC0ED620B378A5041C0E29DE561A22C4DC0F3BB3ADD8C5041C0856225DEA12C4DC03A33CF208E5041C00710855AA12C4DC0E14E1D058F5041C0847567DD9E2C4DC0EEF9D4828F5041C0E6EFDBEF9A2C4DC0C5025469905041C044F0837C9A2C4DC0C78C85FE9C5041C01A7DA344992C4DC007310EB39F5041C01A072D4B942C4DC0BD864C99A05041C0E34C23FA892C4DC0C372A8CAA15041C0359C5C5A872C4DC088997C83A85041C026C7F970932C4DC0B31D814CA75041C0F5A2EB07952C4DC000A1283DAD5041C0E366B38B932C4DC09A532707AF5041C0434764AA8F2C4DC067236E91B15041C0A17918D38D2C4DC095565459BD5041C01FCC98D98A2C4DC0A2C658D9C35041C05AA274AD882C4DC0C31DEF10CA5041C0F1C772D3852C4DC0323FADB9CA5041C07C743588822C4DC0C5BAE6BAC05041C063A2BB05802C4DC0B22AB663C15041C0FD709833832C4DC09A684E31CB5041C0366AE824812C4DC0D640883ECF5041C0043943267D2C4DC0E2E72A80D15041C09D063072772C4DC075F016E9D25041C05FBB3EE2722C4DC03DA41921D45041C0A955B5C76E2C4DC069F51A20D45041C0EB2142A6692C4DC04EB5F2F7D45041C034EC1324672C4DC0372CAEC7D45041C09445DF8A652C4DC0BF108F3FD55041C0A854AB94622C4DC01D93F77DD45041C0CDF0DAC8612C4DC0AAE40283D25041C0F824D9824E2C4DC070FF6B43D65041C0723464E84C2C4DC0B6FD8838DA5041C019FDE1536F2C4DC0D6BB7895E35041C0262722C37F2C4DC04090B85FE85041C0069F63F0822C4DC002391F41E95041C041EF7EA6812C4DC052656486E95041C0ACF395B4802C4DC0E86ECFA1EA5041C03A90B0FB802C4DC09C624856EC5041C032F52BDF812C4DC08385AE95ED5041C0A0C6B36E832C4DC03668D3DFEE5041C051F4A13E842C4DC01109F7E4EF5041C0D4A84B3B822C4DC023534BF8F55041C09A59EDA5812C4DC0D1B7CECDF55041C02EA26F01812C4DC0C3C7FBD2F75041C06C7B1250812C4DC0C9B6048CF95041C0F8A8F6BB812C4DC0721B1FABF95041C00B9DA511832C4DC01D5C4815F85041C032FC07B6832C4DC0170A2351F65041C0432EB129832C4DC01A478A36F65041C0BAABDE34852C4DC086BA4872F15041C0CF70D150862C4DC0D00530EEF05041C0A2E2D23A8B2C4DC0F9EAA32CF15041C063A17E71932C4DC057343D1AF35041C0D39136AF9C2C4DC049EBEB00F65041C03ACF0914A42C4DC043447EEAF55041C03C682E2DAC2C4DC048BBC5F7F55041C0B90BEE45AD2C4DC0B8ACC02AF85041C049678F9AD02C4DC046287CCCF05041C0EC80EDCDEA2C4DC012952295D75041C0C67B081AF22C4DC09CAED943D05041C0DD7274CBF52C4DC057301A49CA5041C011100793F82C4DC03417B2FBC35041C072877ED7032D4DC0320B5B44A95041C0B0B94FA50C2D4DC026490B4A945041C0FF046B5E092D4DC0CD78895C935041C0CB0170E4092D4DC088F1E212925041C07C9DE07F072D4DC06F4B1C62915041C04B85B273092D4DC0CD49244F8C5041C075A1F0230B2D4DC049CA9ACE8C5041C0E1DFA5080E2D4DC09342F0B88B5041C0A83E4978112D4DC00A06F86F8A5041C0A96062A5142D4DC04E631B77895041C01DDB6745182D4DC0013611AF855041C03FC202D91A2D4DC0CCBD0C6D835041C0D4EE26E7202D4DC0DE819A7A855041C0685F4E132B2D4DC09A085F5B885041C0A6874FB72E2D4DC0C3A63B5F885041C0D247E1ED3C2D4DC045E461077A5041C08A9C60834C2D4DC09FD6133F695041C0EC859D37512D4DC07EDBB050655041C0A4319B4C5A2D4DC048401FDE5E5041C07178EC188A2D4DC0CAB16130405041C068940AF1BB2D4DC006459A6F205041C07A06CCE3DF2D4DC0F7DCB22E095041C0B2CAC0ED232E4DC0E828AF4ADD4F41C0B6EDB34D252E4DC02B2B0E65DC4F41C03C69AA4B2F2E4DC0D80E52B2E64F41C01773FD8D2F2E4DC03C5C3AFAE64F41C022E29CD82F2E4DC08F2D8F37E74F41C0D5668425302E4DC0EE7FCA68E74F41C03CAD097D302E4DC04D5C857CE74F41C0A3419EB8302E4DC07284C291E74F41C07CAE7FF6302E4DC0C6466099E74F41C0BEC72238312E4DC0BBFA359DE74F41C0D199CA76312E4DC04AB36E93E74F41C01B3D31B6312E4DC079B6EB8BE74F41C0663B84E6312E4DC065D0AC6AE74F41C0458201104C2E4DC0561EECD8D54F41C018D5714C4D2E4DC0E4926F08D54F41C0E1B5808D512E4DC0D4AC247DD94F41C0","BOCA",16837.6605479,3047342.03682,13241,6416,6825,4,48
61,"0106000020E6100000010000000103000000010000000D00000098E58B4F4D364DC002D9E4D9464E41C085E8B95736364DC07199F8E36B4E41C04910D5B726364DC0FA19476FB14E41C0735C2BD31B364DC04EFFB5F6F34E41C063FC75B716364DC02077E027134F41C080ABABDD0A364DC0F407CFCE894F41C05F84AFF441364DC0637949D78D4F41C06119DBCCC1364DC0613AE902A04F41C0B33CC389F1364DC0B66FD0F2BB4E41C056290B3D0B374DC0163099E1C64E41C0E1B0053D0C374DC07C38A9ED974E41C0EC01CE92D2364DC03808D411804E41C098E58B4F4D364DC002D9E4D9464E41C0","ALMAGRO",3259.31955945,570379.410643,14863,6813,8050,5,5
62,"0106000020E6100000010000000103000000010000000E000000B5E2D1CED6344DC0E975BC5CC64E41C0A457C6CBD6344DC06B825686C64E41C0056F1D54D4344DC0C5AD7892EE4E41C0074B676AD1344DC0CB027956484F41C05E250E4ECE344DC0A58BF027714F41C036C63AC04E354DC05518B5067C4F41C080ABABDD0A364DC0F407CFCE894F41C063FC75B716364DC02077E027134F41C0735C2BD31B364DC04EFFB5F6F34E41C0E533B1F9BE354DC0FD14630CEF4E41C0B2DD31755D354DC080A04184EE4E41C07FC1AC1061354DC09EEE05DDCE4E41C03A7C5EEB0A354DC0CE9C7661CA4E41C0B5E2D1CED6344DC0E975BC5CC64E41C0","ALMAGRO",3007.32911887,480974.064865,9659,4643,5016,5,5
63,"0106000020E6100000010000000103000000010000001D0000005F719E560B354DC05D92E353D54D41C0F3F06AD713354DC0E649D0A8D94D41C0AA4AEEC410354DC0A38FE89EFF4D41C0461FB21C0D354DC0229613D82C4E41C0161E29AAE7344DC0A1F4E43C714E41C07ECDFD77D9344DC0B1F6C61F9B4E41C0B5E2D1CED6344DC0E975BC5CC64E41C03A7C5EEB0A354DC0CE9C7661CA4E41C07FC1AC1061354DC09EEE05DDCE4E41C0B2DD31755D354DC080A04184EE4E41C0E533B1F9BE354DC0FD14630CEF4E41C0735C2BD31B364DC04EFFB5F6F34E41C04910D5B726364DC0FA19476FB14E41C085E8B95736364DC07199F8E36B4E41C098E58B4F4D364DC002D9E4D9464E41C0E6CA471852364DC04D78B0223F4E41C0EF958E6B2B364DC0159A794A394E41C03BBC6217EC354DC023EDEE17164E41C0578C1E54EC354DC0F367A629134E41C0EF13CD79D8354DC0BA22387D0D4E41C0CF127FA8BF354DC0CF7E77220B4E41C0B593AB6996354DC0D0983D94084E41C04C8F67EC9A354DC0428D246DE44D41C07B7157D970354DC0EFD41E9BE44D41C09406B4EE41354DC09BDE9996E44D41C03B1A5C423C354DC008602264E44D41C0DC3F255E2D354DC0D0B17604E34D41C0E99D0BD820354DC0132EFEE2DF4D41C05F719E560B354DC05D92E353D54D41C0","ALMAGRO",3638.92550488,686610.785001,19705,8993,10712,5,5
64,"0106000020E6100000010000000103000000010000001F000000EB3EFEE448364DC064FEA3C02A4D41C04588030E0E364DC0E9B83CA5304D41C03D0639E4E1354DC0D1731D22354D41C01C76BF6EE0354DC0E5E3CB47354D41C0F371D062B2354DC09A9F4CF6394D41C04F00C52F80354DC0665470103F4D41C00E1410F056354DC032EDA82E434D41C0345460800D354DC0D22AE81A514D41C065A16545E3344DC01B327FC3544D41C0653B4175EA344DC03BF6522F744D41C02F52F4F9FB344DC0DE940046BE4D41C050E727CB00354DC0959CC1F3CF4D41C05F719E560B354DC05D92E353D54D41C0E99D0BD820354DC0132EFEE2DF4D41C0DC3F255E2D354DC0D0B17604E34D41C03B1A5C423C354DC008602264E44D41C09406B4EE41354DC09BDE9996E44D41C07B7157D970354DC0EFD41E9BE44D41C04C8F67EC9A354DC0428D246DE44D41C0B593AB6996354DC0D0983D94084E41C0CF127FA8BF354DC0CF7E77220B4E41C0EF13CD79D8354DC0BA22387D0D4E41C0578C1E54EC354DC0F367A629134E41C03BBC6217EC354DC023EDEE17164E41C0EF958E6B2B364DC0159A794A394E41C0E6CA471852364DC04D78B0223F4E41C09BC0B7D254364DC08BBD72BD3A4E41C0E1CE10A85A364DC080635F32F24D41C0DB6012D65C364DC0A05D1B01E84D41C044FF14CD57364DC05DAC2678904D41C0EB3EFEE448364DC064FEA3C02A4D41C0","ALMAGRO",3528.06864669,666785.025085,21668,10036,11632,5,5
65,"0106000020E61000000100000001030000000100000018000000C9C90119A0354DC07DA26273844C41C0CF71B0893F354DC0664D8285864C41C004B4AA2E12354DC0B1DC0908884C41C0BAE97AC9B9344DC08C73008C8B4C41C0035B3B49B9344DC033033E918B4C41C0085D3183C0344DC02E799604B64C41C05624464DCF344DC0579E0442014D41C037E4EE81CF344DC0B4D1074D024D41C0B65AC757DC344DC0D8F1A67E364D41C065A16545E3344DC01B327FC3544D41C0345460800D354DC0D22AE81A514D41C00E1410F056354DC032EDA82E434D41C04F00C52F80354DC0665470103F4D41C0F371D062B2354DC09A9F4CF6394D41C01C76BF6EE0354DC0E5E3CB47354D41C03D0639E4E1354DC0D1731D22354D41C0B69BC778DC354DC092A7D04F0C4D41C07AFEA178D6354DC041BF5B7CE44C41C00D686C0AD3354DC0D7FCD7B9CD4C41C0163D7BE6D0354DC08D82BF14BE4C41C05A93EE77CD354DC0220D972AAA4C41C0A3C7BE9CC9354DC0A3EB6A90904C41C0A64D4F31C8354DC05B492097834C41C0C9C90119A0354DC07DA26273844C41C0","ALMAGRO",2777.3051819,480005.770135,13353,6262,7091,5,5
66,"0106000020E6100000010000000103000000010000001B000000107DC2A051374DC056AE8311104D41C0F13D8D4314374DC0B2D4DBB3C94C41C0B38A717C13374DC0C0D8A80CC94C41C0D4F49B75F7364DC07D0657C3AF4C41C0B1B801D6EE364DC0CADE9192AA4C41C08A6E4F1DC4364DC067D0671C974C41C08E7A566DA1364DC079FA21A6894C41C0C9B121FB99364DC0FFA18759884C41C0BA3A40AF95364DC0388A2534884C41C05375285B91364DC06E260A60874C41C037607C803D364DC019B3E398854C41C013B154C730364DC0B4D4262D834C41C0EBAA297522364DC0454645CF814C41C06AC7F1BFFC354DC0643D4476824C41C0A64D4F31C8354DC05B492097834C41C0A3C7BE9CC9354DC0A3EB6A90904C41C05A93EE77CD354DC0220D972AAA4C41C0163D7BE6D0354DC08D82BF14BE4C41C00D686C0AD3354DC0D7FCD7B9CD4C41C07AFEA178D6354DC041BF5B7CE44C41C0B69BC778DC354DC092A7D04F0C4D41C03D0639E4E1354DC0D1731D22354D41C04588030E0E364DC0E9B83CA5304D41C0EB3EFEE448364DC064FEA3C02A4D41C03915C3CB93364DC0A04CD840234D41C0454C8FE91D374DC02AE37956154D41C0107DC2A051374DC056AE8311104D41C0","ALMAGRO",2939.27732625,477214.406809,12664,5865,6799,5,5
67,"0106000020E6100000010000000103000000010000001B00000026E8389C77374DC0DC4F517E244D41C0009537BE53374DC055ED9C7E124D41C064E9B4C551374DC04D70203B104D41C0107DC2A051374DC056AE8311104D41C0454C8FE91D374DC02AE37956154D41C03915C3CB93364DC0A04CD840234D41C0EB3EFEE448364DC064FEA3C02A4D41C044FF14CD57364DC05DAC2678904D41C0DB6012D65C364DC0A05D1B01E84D41C0E1CE10A85A364DC080635F32F24D41C09BC0B7D254364DC08BBD72BD3A4E41C0E6CA471852364DC04D78B0223F4E41C098E58B4F4D364DC002D9E4D9464E41C0EC01CE92D2364DC03808D411804E41C0E1B0053D0C374DC07C38A9ED974E41C06922DD400C374DC013247740974E41C036F90FCE0D374DC0E9E909E0844E41C0E47718BE14374DC06033F0AA324E41C0593832EE18374DC041A3F1AAEE4D41C047F17B561A374DC0C79417A1EA4D41C0045AEBEE1F374DC049EAB9F5914D41C0D3069E1220374DC07F2A55908F4D41C0339642B223374DC0C83FBB578B4D41C086C5D43A3C374DC00DCFC4106F4D41C0357C375953374DC08A4C39E2514D41C09623A7AF56374DC05E2BF2B44D4D41C026E8389C77374DC0DC4F517E244D41C0","ALMAGRO",3780.39870232,689254.518823,20182,9099,11083,5,5
58,"0106000020E6100000010000000103000000010000001100000037C85E29B5344DC055F75C9DAF5041C09CC040C0AC344DC02D8A5F4E015141C0BBD2B2A7AB344DC0D8E01AD6045141C0C023B7029B344DC0A6D1F91D2F5141C08FA4CDEF97344DC0BFBD6FED365141C08204DBEA8A344DC0927F841B4F5141C0C354BBBC8A344DC0965D9CB15D5141C033BFB0F2A3344DC0D2170D38AD5141C0A125D396E2344DC018A6D9C7B75141C097063D79B2354DC04074C5F4DA5141C008A90C9F34364DC0DDF0562BF25141C04B09A0C277364DC0C48B9524F15041C008D76AC677364DC0DB003316F15041C040EE4C53F7354DC07C51708DE55041C0F4EC0961A7354DC03F6C0920DD5041C08AC03D5E3E354DC0BBA20C53D15041C037C85E29B5344DC055F75C9DAF5041C0","BOEDO",4205.28218982,1051550.19281,13294,6609,6685,5,14
59,"0106000020E610000001000000010300000001000000100000004E12494CBF344DC09DB878CBFE4F41C0B0185BAFBE344DC0E98FF577035041C0FCB2F407BA344DC0DB1EF89E545041C0D8A52A78B7344DC05A49F9C3895041C0F5A9292DB5344DC0977ACC76AF5041C037C85E29B5344DC055F75C9DAF5041C08AC03D5E3E354DC0BBA20C53D15041C0F4EC0961A7354DC03F6C0920DD5041C040EE4C53F7354DC07C51708DE55041C008D76AC677364DC0DB003316F15041C0189D25E377364DC0EEAF6296F05041C09ED60E00A0364DC0EDF24086415041C0AFF8E006A0364DC040033A64415041C0A9777156CA354DC0D8DB3C36225041C0AC51783543354DC0E0B236190E5041C04E12494CBF344DC09DB878CBFE4F41C0","BOEDO",3853.15687438,831900.928817,12152,5906,6246,5,14
60,"0106000020E6100000010000000103000000010000000E0000006119DBCCC1364DC0613AE902A04F41C05F84AFF441364DC0637949D78D4F41C080ABABDD0A364DC0F407CFCE894F41C036C63AC04E354DC05518B5067C4F41C05E250E4ECE344DC0A58BF027714F41C06D5AEBCECA344DC078D26A89994F41C0DDAC165BC8344DC02D8D2889994F41C0B8DC60B4BD344DC034636A84BD4F41C02E6619A0C7344DC063B20987BF4F41C04E12494CBF344DC09DB878CBFE4F41C0AC51783543354DC0E0B236190E5041C0A9777156CA354DC0D8DB3C36225041C0AFF8E006A0364DC040033A64415041C06119DBCCC1364DC0613AE902A04F41C0","BOEDO",3839.80682692,724382.041372,14712,7016,7696,5,14
68,"0106000020E61000000100000001030000000100000019000000FB1A0F5756384DC071C8B0128C4D41C04799FFB038384DC07689B424844D41C09A5A2A6FF5374DC0081AF8F2614D41C01559BD26F5374DC055BDECD0614D41C0D4AEB843B9374DC059500469454D41C0FC311C0CB3374DC08486FA30424D41C026E8389C77374DC0DC4F517E244D41C09623A7AF56374DC05E2BF2B44D4D41C0357C375953374DC08A4C39E2514D41C086C5D43A3C374DC00DCFC4106F4D41C0339642B223374DC0C83FBB578B4D41C0D3069E1220374DC07F2A55908F4D41C0045AEBEE1F374DC049EAB9F5914D41C047F17B561A374DC0C79417A1EA4D41C0593832EE18374DC041A3F1AAEE4D41C0E47718BE14374DC06033F0AA324E41C036F90FCE0D374DC0E9E909E0844E41C05F9502D8FA374DC00545C9F9E94E41C03770CA3602384DC031FADDF4DA4E41C00F9228DA09384DC083C4E58D9B4E41C072C2B0E41B384DC052917AD4724E41C09D24B2E039384DC0629D6DE9304E41C033A1D4D355384DC01B959950ED4D41C03B6003D655384DC0708A9AD2CD4D41C0FB1A0F5756384DC071C8B0128C4D41C0","CABALLITO",3960.78345964,973593.823355,19160,8771,10389,6,6
69,"0106000020E6100000010000000103000000010000001900000036F90FCE0D374DC0E9E909E0844E41C06922DD400C374DC013247740974E41C0E1B0053D0C374DC07C38A9ED974E41C056290B3D0B374DC0163099E1C64E41C0B33CC389F1364DC0B66FD0F2BB4E41C06119DBCCC1364DC0613AE902A04F41C0AFF8E006A0364DC040033A64415041C09ED60E00A0364DC0EDF24086415041C0843D803C56374DC08E53255D5B5041C0BA0A873987374DC0A5F368AF625041C02494621691374DC03CEED7613A5041C0A6020CAB95374DC0B673AF30215041C0899A72B898374DC0A98CC497145041C0C8B6C18A9C374DC060A31562EE4F41C032148F25A2374DC08283EEC6BF4F41C0596246ACA3374DC0AB41120FB94F41C0D5ED20ACB2374DC003954CEF874F41C089D09F12CB374DC0E7E4BAF4484F41C09601DDCBD8374DC0ED0975162E4F41C020D9CCE6EE374DC0E00C8A43034F41C0C0C97F8DF2374DC0BD001F59FC4E41C0FAE9F68AF7374DC0A2C287E3F24E41C07E42D097FA374DC0DB20237EEA4E41C05F9502D8FA374DC00545C9F9E94E41C036F90FCE0D374DC0E9E909E0844E41C0","CABALLITO",4370.53328461,958089.287437,28315,12610,15705,6,6
70,"0106000020E6100000010000000103000000010000002700000096CA96581E394DC07B4E7F44C64D41C0F5F043920B394DC025A9D6E5BD4D41C0C553B65DFE384DC0E573D500B94D41C0FB1A0F5756384DC071C8B0128C4D41C03B6003D655384DC0708A9AD2CD4D41C033A1D4D355384DC01B959950ED4D41C09D24B2E039384DC0629D6DE9304E41C072C2B0E41B384DC052917AD4724E41C00F9228DA09384DC083C4E58D9B4E41C03770CA3602384DC031FADDF4DA4E41C05F9502D8FA374DC00545C9F9E94E41C07E42D097FA374DC0DB20237EEA4E41C0FAE9F68AF7374DC0A2C287E3F24E41C0C0C97F8DF2374DC0BD001F59FC4E41C0FFFB9B8A21384DC0F76AA63E124F41C0D0F94B6239384DC0A6FE1BF41C4F41C004D36D7D43384DC05481FD15214F41C0F653C21865384DC0ADDC96AC304F41C0B05DE2FE6F384DC0F155E2FE344F41C05AEF4BD4B0384DC0DFABDB7B524F41C0B462435FCF384DC09847E291604F41C003EE9392F2384DC0D5008F176E4F41C0D6366E7B0D394DC0856F2B8C794F41C05B30C7B40D394DC05559F4AB794F41C02FFCD61019394DC0202BAEDB5E4F41C0DBA92BF11E394DC0337243AB474F41C0E791317326394DC0B77F2C4F274F41C0D222D7B729394DC0E70207580C4F41C0164CE7A32D394DC0F9B3425BE34E41C010E76EA42D394DC02D51CC91D84E41C0298E642127394DC00656F17AA04E41C0CFD8AD2D25394DC0DD9CB397864E41C09B94BD662A394DC08609934F674E41C091E1EE0E2B394DC01CDEF249594E41C0D73E28102B394DC01183D27A404E41C08F59771D29394DC092EE7C19124E41C0F9FEAC3F27394DC00F2AC616CA4D41C0445B85771E394DC00604F13CC64D41C096CA96581E394DC07B4E7F44C64D41C0","CABALLITO",4288.63226493,1012942.90691,24308,11102,13206,6,6
71,"0106000020E61000000100000001030000000100000024000000C0C97F8DF2374DC0BD001F59FC4E41C020D9CCE6EE374DC0E00C8A43034F41C09601DDCBD8374DC0ED0975162E4F41C089D09F12CB374DC0E7E4BAF4484F41C0D5ED20ACB2374DC003954CEF874F41C0596246ACA3374DC0AB41120FB94F41C032148F25A2374DC08283EEC6BF4F41C0C8B6C18A9C374DC060A31562EE4F41C0899A72B898374DC0A98CC497145041C0A6020CAB95374DC0B673AF30215041C02494621691374DC03CEED7613A5041C0BA0A873987374DC0A5F368AF625041C05AB5743EF5374DC0A5F6FC1F735041C09344D086B1384DC0CEBC42488E5041C06A47230DB2384DC03AF6B65C8E5041C084293F6EB9384DC08CCD0908665041C095ED570CBC384DC0E800E0D1405041C022C4655CBD384DC066958CB2235041C0161E50ACBE384DC058CF5F80085041C0AC9B17F5C4384DC0F561A551CA4F41C07C8894B9C6384DC08EB75F99C24F41C0D3B9C6D7C6384DC0D0530115C24F41C04A9AC3E7E2384DC0D7AD7418994F41C07665D24AFB384DC02B81AA76A34F41C071C9D45B0B394DC071AAC8367F4F41C05B30C7B40D394DC05559F4AB794F41C0D6366E7B0D394DC0856F2B8C794F41C003EE9392F2384DC0D5008F176E4F41C0B462435FCF384DC09847E291604F41C05AEF4BD4B0384DC0DFABDB7B524F41C0B05DE2FE6F384DC0F155E2FE344F41C0F653C21865384DC0ADDC96AC304F41C004D36D7D43384DC05481FD15214F41C0D0F94B6239384DC0A6FE1BF41C4F41C0FFFB9B8A21384DC0F76AA63E124F41C0C0C97F8DF2374DC0BD001F59FC4E41C0","CABALLITO",4087.67427766,936260.88862,29245,13013,16232,6,6
72,"0106000020E610000001000000010300000001000000100000000F041C41CF3A4DC05F1C9BBB934E41C0E9BEC9E8D23A4DC09206021A8E4E41C0F83FF5C8393B4DC0E83945D7BE4D41C03BCA183FAF3A4DC093A76200604D41C09DE80333B2394DC0E43EE38DA14D41C0445B85771E394DC00604F13CC64D41C0F9FEAC3F27394DC00F2AC616CA4D41C0E115D6364A394DC0D0F2E66BD94D41C0A67276F158394DC0BB9B40C4DF4D41C09031968C78394DC00BBB3684F04D41C01A40950FBA394DC0AF4295CA134E41C0A07782110D3A4DC01CC6C1B5404E41C0A6E0F82A213A4DC0FB41BC614C4E41C0E286B83C5E3A4DC056736144664E41C0ED91859ABC3A4DC0DAF413958C4E41C00F041C41CF3A4DC05F1C9BBB934E41C0","CABALLITO",3856.92245496,803621.818414,12639,5968,6671,6,6
73,"0106000020E610000001000000010300000001000000230000005B30C7B40D394DC05559F4AB794F41C00B22EF9111394DC0B3C16BCD7B4F41C0397F276A29394DC03D129761854F41C0A95D7B0474394DC045752A1FA54F41C09AB35F2BB9394DC0545B135AC04F41C0F906515E003A4DC001213B85DC4F41C064C665922F3A4DC05E06EDEBEE4F41C02CEFE6B82F3A4DC0EF33F797EE4F41C061BF7B14603A4DC06A81696F844F41C082BAAF77723A4DC01709785C5C4F41C0676E657A873A4DC01AAEFB912E4F41C07923CC0DCF3A4DC0EF47040B944E41C00F041C41CF3A4DC05F1C9BBB934E41C0ED91859ABC3A4DC0DAF413958C4E41C0E286B83C5E3A4DC056736144664E41C0A6E0F82A213A4DC0FB41BC614C4E41C0A07782110D3A4DC01CC6C1B5404E41C01A40950FBA394DC0AF4295CA134E41C09031968C78394DC00BBB3684F04D41C0A67276F158394DC0BB9B40C4DF4D41C0E115D6364A394DC0D0F2E66BD94D41C0F9FEAC3F27394DC00F2AC616CA4D41C08F59771D29394DC092EE7C19124E41C0D73E28102B394DC01183D27A404E41C091E1EE0E2B394DC01CDEF249594E41C09B94BD662A394DC08609934F674E41C0CFD8AD2D25394DC0DD9CB397864E41C0298E642127394DC00656F17AA04E41C010E76EA42D394DC02D51CC91D84E41C0164CE7A32D394DC0F9B3425BE34E41C0D222D7B729394DC0E70207580C4F41C0E791317326394DC0B77F2C4F274F41C0DBA92BF11E394DC0337243AB474F41C02FFCD61019394DC0202BAEDB5E4F41C05B30C7B40D394DC05559F4AB794F41C0","CABALLITO",5005.64225362,1390149.38881,16146,7616,8530,6,6
74,"0106000020E610000001000000010300000001000000180000006A47230DB2384DC03AF6B65C8E5041C085BCFFD8CC394DC0DCE4A7D7B85041C007E38AFBED394DC0DCA398E1735041C0A307C2DC1A3A4DC06406C3C0185041C0F2BF972B1E3A4DC00E2C2C08145041C0C8C73E7A2F3A4DC08CBAD51DEF4F41C064C665922F3A4DC05E06EDEBEE4F41C0F906515E003A4DC001213B85DC4F41C09AB35F2BB9394DC0545B135AC04F41C0A95D7B0474394DC045752A1FA54F41C0397F276A29394DC03D129761854F41C00B22EF9111394DC0B3C16BCD7B4F41C05B30C7B40D394DC05559F4AB794F41C071C9D45B0B394DC071AAC8367F4F41C07665D24AFB384DC02B81AA76A34F41C04A9AC3E7E2384DC0D7AD7418994F41C0D3B9C6D7C6384DC0D0530115C24F41C07C8894B9C6384DC08EB75F99C24F41C0AC9B17F5C4384DC0F561A551CA4F41C0161E50ACBE384DC058CF5F80085041C022C4655CBD384DC066958CB2235041C095ED570CBC384DC0E800E0D1405041C084293F6EB9384DC08CCD0908665041C06A47230DB2384DC03AF6B65C8E5041C0","CABALLITO",3526.64909898,776421.948057,21587,9883,11704,6,6
79,"0106000020E6100000010000000103000000010000000C000000B9096DCB283D4DC0D55D1D70AA4F41C0AD621B2A5E3C4DC0673BE567404F41C05486E7370C3C4DC092965CA8144F41C0D0821DB7F13B4DC0508EF91D514F41C0A9AF47B4BA3B4DC015577C11CE4F41C07421825F9A3B4DC0B6312280175041C07AEE3EAE793B4DC03DC09952635041C0CEC4CCA72F3C4DC0E41306B2915041C05FF92730AF3C4DC038038000B25041C0D2FCE703B13C4DC0F1A612FEAD5041C086042A1BDC3C4DC02B0837764F5041C0B9096DCB283D4DC0D55D1D70AA4F41C0","FLORES",4010.23459248,986231.130374,16108,7607,8501,7,10
80,"0106000020E610000001000000010300000001000000100000005486E7370C3C4DC092965CA8144F41C0AC8E882D0B3C4DC027AF2A1A144F41C03F677864FC3B4DC0C44A87280C4F41C0EA25D3C4E63B4DC04A597BD6024F41C0110AA41E9B3B4DC0DF311A64E24E41C0F1237BEF733B4DC02949A194D14E41C07923CC0DCF3A4DC0EF47040B944E41C0676E657A873A4DC01AAEFB912E4F41C082BAAF77723A4DC01709785C5C4F41C01812C40BC23A4DC0221213D2774F41C081CA816FEC3A4DC0A3783296854F41C01EC9C8B55B3B4DC0E3E6B6C3B04F41C005C8CB668B3B4DC0C7567749C24F41C0A9AF47B4BA3B4DC015577C11CE4F41C0D0821DB7F13B4DC0508EF91D514F41C05486E7370C3C4DC092965CA8144F41C0","FLORES",3380.47000313,702946.135364,12312,5840,6472,7,10
81,"0106000020E6100000010000000103000000010000001100000082BAAF77723A4DC01709785C5C4F41C061BF7B14603A4DC06A81696F844F41C02CEFE6B82F3A4DC0EF33F797EE4F41C064C665922F3A4DC05E06EDEBEE4F41C0C8C73E7A2F3A4DC08CBAD51DEF4F41C0E3CE2E45893A4DC0B89E32BC125041C021708FF1F03A4DC00F8D8C353B5041C0A7B8FD9E103B4DC0C47E66BB445041C0F7A22B42493B4DC0E6B870FB565041C07AEE3EAE793B4DC03DC09952635041C07421825F9A3B4DC0B6312280175041C0A9AF47B4BA3B4DC015577C11CE4F41C005C8CB668B3B4DC0C7567749C24F41C01EC9C8B55B3B4DC0E3E6B6C3B04F41C081CA816FEC3A4DC0A3783296854F41C01812C40BC23A4DC0221213D2774F41C082BAAF77723A4DC01709785C5C4F41C0","FLORES",3071.0482797,543212.169767,11764,5389,6375,7,10
82,"0106000020E6100000010000000103000000010000000B000000B2F52361283B4DC0623DF0A8245141C0AB6B5E32693B4DC033CDBAB4385141C07B0C330A543C4DC0E09157927D5141C07E9E43B1733C4DC0B8886D9C365141C081ACFA749B3C4DC0F09B4147DD5041C05FF92730AF3C4DC038038000B25041C0CEC4CCA72F3C4DC0E41306B2915041C07AEE3EAE793B4DC03DC09952635041C0A6D554D1773B4DC0B5FB27A5675041C0A0FA6694653B4DC0B011E6B3915041C0B2F52361283B4DC0623DF0A8245141C0","FLORES",3224.8908891,642299.553221,14727,6892,7835,7,10
83,"0106000020E61000000100000001030000000100000012000000C8C73E7A2F3A4DC08CBAD51DEF4F41C0F2BF972B1E3A4DC00E2C2C08145041C0A307C2DC1A3A4DC06406C3C0185041C007E38AFBED394DC0DCA398E1735041C085BCFFD8CC394DC0DCE4A7D7B85041C0687403CD203A4DC0D5977959D25041C062981D64293A4DC072146BD0D45041C048687700293A4DC0396F4891D55041C010A6588ABF3A4DC0199A043D045141C0B2F52361283B4DC0623DF0A8245141C0A0FA6694653B4DC0B011E6B3915041C0A6D554D1773B4DC0B5FB27A5675041C07AEE3EAE793B4DC03DC09952635041C0F7A22B42493B4DC0E6B870FB565041C0A7B8FD9E103B4DC0C47E66BB445041C021708FF1F03A4DC00F8D8C353B5041C0E3CE2E45893A4DC0B89E32BC125041C0C8C73E7A2F3A4DC08CBAD51DEF4F41C0","FLORES",3477.22969806,715615.635181,21422,9674,11748,7,10
84,"0106000020E610000001000000010300000001000000110000000ABB905A553A4DC00B35B6F8FB5141C08BB869FA663A4DC043308B8B055241C066DEB08E7A3A4DC043626586105241C070336E23F23A4DC096CDED97485241C0941720C2463B4DC0A8BE12E56F5241C023C4F6AF803B4DC014DBDA608A5241C06DC19C60873B4DC0E58D576E865241C0E3D456BD883B4DC07EEA3957855241C04781B36A113C4DC0A03FE61D185241C0FEE7A5FF533C4DC0CC888AAA7D5141C07B0C330A543C4DC0E09157927D5141C0AB6B5E32693B4DC033CDBAB4385141C0B2F52361283B4DC0623DF0A8245141C0DB188ED1233B4DC07735BF9C2F5141C0EF41AF7E073B4DC0A79E69186F5141C01EFC0C9BA43A4DC043661D7ABA5141C00ABB905A553A4DC00B35B6F8FB5141C0","FLORES",3931.58427829,953951.596595,11472,5544,5928,7,10
85,"0106000020E6100000010000000103000000010000001300000048687700293A4DC0396F4891D55041C079620CB6173A4DC002376220F75041C0C34A0024CC394DC07CCA024A915141C0CC9F3B77C9394DC07268875E975141C07D634C6EC8394DC0CD30406A985141C0A59ABC12EB394DC0CB640924AB5141C0C1F4A8130C3A4DC0FC1A7B2DBD5141C0968553AB113A4DC0DB008856C15141C0D960BE61183A4DC03E26D3CFC75141C0EB058ACE253A4DC07D882225D65141C02AC289393A3A4DC0A50978F4EA5141C022344E814E3A4DC06CCF9C3FF85141C00ABB905A553A4DC00B35B6F8FB5141C01EFC0C9BA43A4DC043661D7ABA5141C0EF41AF7E073B4DC0A79E69186F5141C0DB188ED1233B4DC07735BF9C2F5141C0B2F52361283B4DC0623DF0A8245141C010A6588ABF3A4DC0199A043D045141C048687700293A4DC0396F4891D55041C0","FLORES",2958.38393405,548571.699213,8163,3844,4319,7,10
86,"0106000020E610000001000000010300000001000000780000007D634C6EC8394DC0CD30406A985141C0B0E66B71C7394DC024DB1F69995141C0ED3BD2BEA3394DC076690A1CB05141C0AE7A85738D394DC0F0765B4DBF5141C0D26C356886394DC0A70D2E4FC45141C050617AC17D394DC0F440EFD1CA5141C0FCBE57735C394DC0BA171FE4E35141C0BABBF0DA3B394DC0B23358C7FC5141C06F7B57821D394DC00F2E56BC145241C04F7ED4D5FF384DC0363F1D482A5241C0A35D692AFE384DC08AF88F3D2E5241C05A7AB248EB384DC0F572E48E3C5241C0430E2952DD384DC06358E225475241C02D2B03F3B6384DC0A8DA88DA255241C004CF37DAA1384DC04F25F2D3425241C08D9A06CD0C384DC078F6A1B3CE5241C00ABB4F75FD374DC0DFB60282DC5241C04CA52F7BAD374DC063CC9270B85241C068F87ACBAB374DC0FF5A62B3B75241C0ABA34185AB374DC036DEBBFCB75241C06456276E9F374DC08B6E068CC45241C01410EBB59D374DC06FA0C254C65241C0B138BF9E85374DC0772BC5B8D95241C048E71E8179374DC03BA16024E25241C062642BD06A374DC015F35147EE5241C05280CB1C4A374DC0A702DF26085341C03FC5268118374DC0751AB7ED2E5341C05CAF583018374DC002913A2D2F5341C095B255F828374DC075D6F2E13D5341C032814C102A374DC0B51FD8D73E5341C0D5FAB74439374DC0ACF99BF34A5341C0ACBF303544374DC05276CEAA535341C000CD70D74D374DC0C756B0E15A5341C0FD14950050374DC0137340B55C5341C0C53BF5536C374DC0AC8B0AAD745341C0F3D914659B374DC0FD42571D9A5341C08BDBB142CE374DC0B16D1896C15341C0FB8EBB60CF374DC09E91C373C25341C0C77C3DD2F2374DC0F48E6B85DA5341C0532DDF8A0F384DC0C882818AF05341C0993229A810384DC029E6B98BF15341C0808591391E384DC03366C9C9E65341C01A9E164A23384DC0AB745727E25341C0D8C0357D2D384DC0EE6B8948D95341C0DA76DF895F384DC08C139F84B25341C040F4277060384DC03B2516C9B15341C09A602D6484384DC02188FA69955341C0DDC6AABE87384DC06D1D71C4925341C090E3C421B4384DC0F72A2198705341C036DAF8FBBA384DC0A78D8468665341C0CC5EBED4BB384DC04008E95D645341C0216DE3FFBD384DC0147A102A5F5341C0B4B95C46BE384DC0566F94A25A5341C089D2BA7DC4384DC0C3D9E9EC585341C05BD250C7C8384DC0FEA6A69A585341C07AFA5B10D3384DC0E310E5D4575341C0F5297A13E2384DC0AA7CD55F565341C0891D6D02E9384DC05CEA0244525341C0894E9D4FF5384DC017905B2F545341C066E0FCCA35394DC04CB2EBA9565341C0FD5C52B66C394DC071D9CE6B595341C02B5370716E394DC0AB8ACA81595341C06B2001579C394DC0EBF60D64595341C09BE02EBCDA394DC0EC5B4255565341C073BD71F5DB394DC05B6A4B39565341C0770BF940FB394DC0C1602869535341C067CD6EF7053A4DC0BCBACF72525341C078E3980D323A4DC082F5BF344E5341C098484F31343A4DC03B22E2955A5341C019EA8808373A4DC007C6B9606E5341C0301BC42F373A4DC06F6BCA746F5341C0BC9511263B3A4DC01B96FE387A5341C093395B043F3A4DC03DB64A677E5341C0C68CA69D453A4DC01B8F3F08845341C0611E82034D3A4DC0E49F2A578A5341C09E894314603A4DC04811886E9A5341C06C7624207E3A4DC0C361AFCAB35341C0CE3FBC97823A4DC02392B9F9B75341C06D80B5F6923A4DC04631123FC65341C05EBC4B21BE3A4DC0936D1BACE95341C0498E45A2BF3A4DC0DFC0CE62EB5341C07FFBC2C3C43A4DC00163703FF15341C0523295B7C53A4DC04E3D8956F25341C037B03619ED3A4DC0FB0337E1125441C06986E8DA0E3B4DC0D61C5F3AFA5341C0F123D04C103B4DC0AFF75B2CF95341C0ABDD2D59313B4DC09896E1E9DA5341C083D9B589593B4DC05B733AEABB5341C0F5A67DF5633B4DC05F7CC1CBB35341C0AF914C9B773B4DC09B233640A75341C0475B8F549B3B4DC0D0B402348B5341C082B2DFADA03B4DC0DEFB1E82865341C0150BAD61AE3B4DC023CF69797A5341C00A5438C1B83B4DC04FF4B410705341C0FBD5F8E2BA3B4DC04784DAED6D5341C0A03E7391C13B4DC01383358A685341C0197C4717C73B4DC069EA5616645341C028CE593EA53B4DC04E059F84345341C00745E0BEA33B4DC01A99ABAC325341C057B221B8733B4DC051D29E74F75241C0E2110AAE603B4DC062BFA26CE35241C067FA5E4E503B4DC07ECCEC0DCC5241C043D06135433B4DC010B1D8E9B55241C0873C407F513B4DC0EC55114DAD5241C0AC6C2CF6673B4DC0DEC1C2159C5241C05D1924F57C3B4DC09A631A958C5241C023C4F6AF803B4DC014DBDA608A5241C0941720C2463B4DC0A8BE12E56F5241C070336E23F23A4DC096CDED97485241C066DEB08E7A3A4DC043626586105241C08BB869FA663A4DC043308B8B055241C00ABB905A553A4DC00B35B6F8FB5141C022344E814E3A4DC06CCF9C3FF85141C02AC289393A3A4DC0A50978F4EA5141C0EB058ACE253A4DC07D882225D65141C0D960BE61183A4DC03E26D3CFC75141C0968553AB113A4DC0DB008856C15141C0C1F4A8130C3A4DC0FC1A7B2DBD5141C0A59ABC12EB394DC0CB640924AB5141C07D634C6EC8394DC0CD30406A985141C0","FLORES",9545.36126946,3501722.41992,25453,12664,12789,7,10
75,"0106000020E61000000100000001030000000100000018000000D0FD0D502C384DC0DE87B3A04F5141C0F33268A12D384DC095BDCFE14F5141C0D28AE1A3D6384DC00C8CF0D6725141C0D3BC929E11394DC0B5D319C37D5141C08DACF90067394DC034DCAFB3A85141C0D26C356886394DC0A70D2E4FC45141C0AE7A85738D394DC0F0765B4DBF5141C0ED3BD2BEA3394DC076690A1CB05141C0B0E66B71C7394DC024DB1F69995141C07D634C6EC8394DC0CD30406A985141C0CC9F3B77C9394DC07268875E975141C0C34A0024CC394DC07CCA024A915141C079620CB6173A4DC002376220F75041C048687700293A4DC0396F4891D55041C062981D64293A4DC072146BD0D45041C0687403CD203A4DC0D5977959D25041C085BCFFD8CC394DC0DCE4A7D7B85041C06A47230DB2384DC03AF6B65C8E5041C09344D086B1384DC0CEBC42488E5041C0C2C09262AC384DC010375E78A85041C0662D891898384DC0A0B2E75EC55041C03FBAAABB57384DC03DBBB92D195141C0F6A9A35A2C384DC074C070824F5141C0D0FD0D502C384DC0DE87B3A04F5141C0","PARQUE CHACABUCO",3862.81240133,861842.524804,9742,4565,5177,7,32
76,"0106000020E610000001000000010300000001000000100000009344D086B1384DC0CEBC42488E5041C05AB5743EF5374DC0A5F6FC1F735041C0BA0A873987374DC0A5F368AF625041C0843D803C56374DC08E53255D5B5041C09ED60E00A0364DC0EDF24086415041C0189D25E377364DC0EEAF6296F05041C07ABE71CFA6364DC0D7C8C8EDF95041C096B0094045374DC00B83A070135141C07A36329D63374DC096905ED2275141C09FB97E9F8F374DC02C10284A315141C0D0FD0D502C384DC0DE87B3A04F5141C0F6A9A35A2C384DC074C070824F5141C03FBAAABB57384DC03DBBB92D195141C0662D891898384DC0A0B2E75EC55041C0C2C09262AC384DC010375E78A85041C09344D086B1384DC0CEBC42488E5041C0","PARQUE CHACABUCO",4141.24023358,923261.266608,14937,6978,7959,7,32
77,"0106000020E61000000100000001030000000100000018000000189D25E377364DC0EEAF6296F05041C008D76AC677364DC0DB003316F15041C04B09A0C277364DC0C48B9524F15041C008A90C9F34364DC0DDF0562BF25141C0CCE7CF1F01374DC0B1E6FC9A145241C07E4CFE7707374DC0C1F7708A155241C022481F7614374DC0B3797075175241C0EA2A93FE2A374DC079CFE6291B5241C0AC2C13F82D374DC03D9E7BCD1B5241C0E8F57FF356374DC07123919C245241C03827BE3A4F374DC0B40B4EB6945241C08C8CC64E5E374DC07CE9BEC0955241C0A42EFCA4AB374DC02FE0BDA2B75241C068F87ACBAB374DC0FF5A62B3B75241C0ADB5E101AC374DC0A1BCDC19B75241C070C0ED40C8374DC064C1DD46675241C004ECB8CEFD374DC05DC8B291D15141C01251AA0E18384DC048983794875141C0D0FD0D502C384DC0DE87B3A04F5141C09FB97E9F8F374DC02C10284A315141C07A36329D63374DC096905ED2275141C096B0094045374DC00B83A070135141C07ABE71CFA6364DC0D7C8C8EDF95041C0189D25E377364DC0EEAF6296F05041C0","PARQUE CHACABUCO",4934.94234214,1191250.8554,12762,6325,6437,7,32
78,"0106000020E6100000010000000103000000010000001900000068F87ACBAB374DC0FF5A62B3B75241C04CA52F7BAD374DC063CC9270B85241C00ABB4F75FD374DC0DFB60282DC5241C08D9A06CD0C384DC078F6A1B3CE5241C004CF37DAA1384DC04F25F2D3425241C02D2B03F3B6384DC0A8DA88DA255241C0430E2952DD384DC06358E225475241C05A7AB248EB384DC0F572E48E3C5241C0A35D692AFE384DC08AF88F3D2E5241C04F7ED4D5FF384DC0363F1D482A5241C06F7B57821D394DC00F2E56BC145241C0BABBF0DA3B394DC0B23358C7FC5141C0FCBE57735C394DC0BA171FE4E35141C050617AC17D394DC0F440EFD1CA5141C0D26C356886394DC0A70D2E4FC45141C08DACF90067394DC034DCAFB3A85141C0D3BC929E11394DC0B5D319C37D5141C0D28AE1A3D6384DC00C8CF0D6725141C0F33268A12D384DC095BDCFE14F5141C0D0FD0D502C384DC0DE87B3A04F5141C01251AA0E18384DC048983794875141C004ECB8CEFD374DC05DC8B291D15141C070C0ED40C8374DC064C1DD46675241C0ADB5E101AC374DC0A1BCDC19B75241C068F87ACBAB374DC0FF5A62B3B75241C0","PARQUE CHACABUCO",4213.95458485,856730.293238,10464,5121,5343,7,32
89,"0106000020E610000001000000010300000001000000790000004D19360FD53C4DC018B4D98DA05541C06EF48772B93C4DC04B3CDE028A5541C0945F0475AC3C4DC0836E3CFD7E5541C0DBF430859B3C4DC01CF7BA9B705541C0D9566385923C4DC069FCC5F8685541C06D334E3F8C3C4DC0A36B73A4635541C0C6095ECB7C3C4DC08B1C9886565541C0557BF7A4783C4DC0CE445900535541C0678659676D3C4DC0007AD274495541C09BB36BE75D3C4DC0A871184D3C5541C083ADB6824E3C4DC06CE84A3B2F5541C06A64BE36453C4DC072714057275541C051C1C2F33E3C4DC026A7EB05225541C00B48A0652E3C4DC0612942DC135541C0897DA3402E3C4DC035283DF8135541C0702FE4C9263C4DC0778720CB195541C0AEC09917FD3B4DC0BB1C59523A5541C0D5EA8EC4E53B4DC0D14EAD094C5541C02308E6977D3B4DC04C6E0BDC9D5541C0032CD451693B4DC0447F6BE3A25541C04DE09D83593B4DC0F35422CFA65541C0C8E3ACE24A3B4DC0CB538D52AE5541C0D0F36F35403B4DC0007EEE0FBB5541C05024268D3D3B4DC0CC2B4CD7BE5541C060BC07A7383B4DC0A47D41CDC55541C04ABE4E53363B4DC0B25F5F1CC95541C076084B3B323B4DC06BD1022FCE5541C0E1E67D352C3B4DC07F428CA5D55541C0A5CBD7402B3B4DC06BA3D5D4D65541C09933DC6C253B4DC0A6C46354DC5541C0AD7251161D3B4DC0B0E3C931E45541C0A48C1244103B4DC01434B51BEF5541C0E63F70810A3B4DC071885B12F45541C070CF327F093B4DC0AC0C78F1F45541C0922AF41EE13A4DC0C7929147175641C062C16093DB3A4DC05A78BF7A1E5641C09F8591F8DA3A4DC04794630F205641C0FFE7B932D93A4DC08D4B17B2245641C0D41EE46CD63A4DC09D904CE52B5641C0DC07BEA1D53A4DC0C93058CE305641C052A7A8DCD33A4DC0B7069FD8335641C044C9E18BD23A4DC0D387351B365641C0F855731BCE3A4DC096F17AF8395641C0CAD13685CC3A4DC0DE3B9E9F3A5641C05D02208FC83A4DC088AB9D423C5641C020BD9303C33A4DC020FEAB3D3D5641C0570B4056B63A4DC01FB3A48C3E5641C038CAFD73AA3A4DC04182A021435641C064C5D0472B3A4DC0D3EAFC49A65641C048D46BD5B2394DC0A58F5FDC045741C0E7B473C2B0394DC08BC2EDD2075741C03D4EDA79AE394DC05E1D5F140B5741C016BDCDB6B2394DC0308E0AFF0F5741C0B564E2B5B5394DC0FECB9378135741C00D5C5B03BD394DC0CF8134321A5741C0A26ECBFEBD394DC013EA6B1A1B5741C01703BCA4033A4DC0BE98CA445B5741C0EF0823E4043A4DC0766F2E7D5C5741C0AECF7353623A4DC00137EC00B25741C0AF925A6C633A4DC0DC36101BB35741C05007D5137C3A4DC01591E154C45741C01CBEE6B37E3A4DC00724D1BBC65741C06339C303AC3A4DC09A439530F05741C089DCB24DB93A4DC0FD076AC0015841C0BF85B3E1B93A4DC0BDC84F84025841C0D91AC91AF63A4DC09D954880395841C06DCB2F76243B4DC0CD8EA464635841C087523771503B4DC01E86AE448C5841C03A829E84673B4DC05FF399AC7A5841C02816B9B8903B4DC0AE11C3955A5841C099C9DC1CB63B4DC02A714A283D5841C019101C89DC3B4DC05182CC851F5841C07F79C32A003C4DC03A77C411035841C0777C90B5263C4DC03B002A1EE55741C0F41B47A54E3C4DC075E25927C55741C0C50B6693703C4DC01D5535F7AA5741C0E3AC2953743C4DC0BB9AB56FA85741C05DA53EB2783C4DC0DFDA057CA55741C028359580943C4DC077D90FE48F5741C07B42C3D2993C4DC0A9C214C48B5741C0FC0CA553C03C4DC0B91887066E5741C0F30EFF8FC23C4DC01396C64C6C5741C0107FFC57DE3C4DC05E1B14E5565741C043B92654E03C4DC0C9083C5D555741C019A265D7E43C4DC023A920E2515741C08D6064E0E63C4DC0311A7850505741C0907CB951FE3C4DC0E5DC7B76655741C01C970573003D4DC0D0B00A62675741C02F179593023D4DC0C4309E4D695741C00A8CD264173D4DC03BCBBA097C5741C09E0FDA80193D4DC0920A29E67D5741C00808A09D1B3D4DC087815CC37F5741C0786A6B42303D4DC057588F8B925741C0E480944E323D4DC0C3CBCA6E945741C0D888C35A343D4DC09D20C952965741C0028B5944493D4DC059A0530DA95741C0017E8E534B3D4DC039A8BAE6AA5741C05F04C5624D3D4DC0DFD85FBFAC5741C0B2B1312B623D4DC069DEE97CBF5741C0B4C42438643D4DC0A9706C62C15741C0835C5844663D4DC0D69AEC47C35741C0ADF9DC2E7B3D4DC071066D24D65741C0A7DAD13B7D3D4DC07B179A01D85741C08B3F07487F3D4DC017A9CADED95741C0200CDB09943D4DC0B2E2F496EC5741C09154A823963D4DC0AB8FBA7EEE5741C09C3D3B3E983D4DC0B95B3E67F05741C0D64951F6AC3D4DC0AB848F34035841C0DF522713AF3D4DC02F9CEA26055841C0D0D80130B13D4DC08FE64019075841C0D1A32196DE3D4DC0951940AA2F5841C0110CFB91283E4DC01DA86DEDF75741C09A331FC3F53D4DC08B29EA73BD5741C0B7299287D13D4DC0686544A2925741C062E6BAF2AC3D4DC029BA60826C5741C0AF4166D28F3D4DC042525D61465741C069EB5531803D4DC0FAEA1F88255741C00673585D523D4DC02CB4642EBA5641C02EB826C2173D4DC045D1359B355641C0D77C433DF43C4DC01FF0D8D3E55541C04D19360FD53C4DC018B4D98DA05541C0","VILLA LUGANO",10058.0622391,4524565.79088,46140,23699,22441,8,19
90,"0106000020E61000000100000001030000000100000079000000CC116029723B4DC0C292A0C07C5441C0F97A2CF8733B4DC0CBB7083F7E5441C0803C1DDF753B4DC03DC7A9D07F5441C0DBEB7EAE923B4DC0D13C7AE19C5441C080BF909B933B4DC0A6A57CD09D5441C0F123D438B73B4DC0E26926F4BC5441C096C2EB6BE83B4DC013E93231E75441C0E35D4E1EF53B4DC0BA223917F25441C052181F4CFA3B4DC0B123CF4BF55441C08456E4BAFE3B4DC04B3CDEFAF65441C0DFF8F456033C4DC06A2A5BEEF75441C07BEB3436083C4DC0EA03C6BCF85441C05BB41B9E0D3C4DC06EA1632DF95441C0EC11A6E5103C4DC01E74813FF95441C065E7D443143C4DC09C02D15EF85441C0DDB13413183C4DC01FD22AE1F55441C0868BDF8E1A3C4DC0A225DB1FF45441C07D592E931D3C4DC068EB0C60F25441C03C30B22D223C4DC0F6168C1EF15441C0F3E3AB0D273C4DC08E5E87AEF05441C0AC9B25992A3C4DC052638E9BF05441C0B739E3DC2E3C4DC07698163BF15441C008F845FA2F3C4DC0312CCBE9F15441C0F1216665323C4DC0CEF4EA63F35441C0DBF96EC7353C4DC0340EC95FF65441C0EF354318373C4DC091A03D33FA5441C07C3EFDA0373C4DC047422702FE5441C0714F9411383C4DC03F8F0F09025541C03048F5F4373C4DC0D7BEA8A5045541C0EE778D65373C4DC07F318D09075541C0DCC69165373C4DC01182520A075541C05236D264373C4DC065A6960C075541C027C9CC74363C4DC0DD6419130A5541C0054C8FF4343C4DC0EAC476530C5541C0897DA3402E3C4DC035283DF8135541C00B48A0652E3C4DC0612942DC135541C051C1C2F33E3C4DC026A7EB05225541C06A64BE36453C4DC072714057275541C083ADB6824E3C4DC06CE84A3B2F5541C09BB36BE75D3C4DC0A871184D3C5541C0678659676D3C4DC0007AD274495541C0557BF7A4783C4DC0CE445900535541C0C6095ECB7C3C4DC08B1C9886565541C06D334E3F8C3C4DC0A36B73A4635541C0D9566385923C4DC069FCC5F8685541C0DBF430859B3C4DC01CF7BA9B705541C0945F0475AC3C4DC0836E3CFD7E5541C06EF48772B93C4DC04B3CDE028A5541C04D19360FD53C4DC018B4D98DA05541C0D77C433DF43C4DC01FF0D8D3E55541C02EB826C2173D4DC045D1359B355641C00673585D523D4DC02CB4642EBA5641C069EB5531803D4DC0FAEA1F88255741C0AF4166D28F3D4DC042525D61465741C062E6BAF2AC3D4DC029BA60826C5741C0B7299287D13D4DC0686544A2925741C09A331FC3F53D4DC08B29EA73BD5741C0110CFB91283E4DC01DA86DEDF75741C016DFB6C452404DC02BB2D84B565641C0FCAD6E8026404DC079D747D93C5641C099C2195416404DC069794036345641C0785B9AEB0C404DC05E0375302F5641C064B8F7B703404DC091ACD6422A5641C0D7D49B2700404DC0D846855A285641C02F611FD2FA3F4DC00C99477D255641C02B3FFB81F73F4DC0104C36B6235641C017B10890ED3F4DC0415507611E5641C0BCE09230E23F4DC0536E4D4A185641C004AFDFBCDC3F4DC0A3A5924F155641C04F9B6B95D73F4DC03DE8E506125641C0986A4089C43F4DC0C4FCDC6E045641C0BF1EC67CBB3F4DC012FE3400FE5541C04666E90BB33F4DC0DBA02BFFF75541C0AFDF86E0AA3F4DC0B7313C29F25541C018FACA2BA43F4DC0261BE85BED5541C088E40F939F3F4DC0011DE810EA5541C08D5CEE53783F4DC08B21867DC85541C089925E07733F4DC0A965289DC35541C00AAE9F79313F4DC0748B9942825541C0ABF71DAC2E3F4DC0215D3EEA7F5541C048B5C41B2B3F4DC0B7F252EF7C5541C0402C365F053F4DC032599900535541C07F46FC2A023F4DC0120CD9E24F5541C0BA6C8941FF3E4DC01027E2064D5541C06FD1516FF73E4DC095CFFF4B455541C0FAB5CB63F23E4DC021FA4547405541C077A862D6EC3E4DC08DA200C23A5541C01A300044D93E4DC0B8F26B55275541C06CF7957CD73E4DC0368E3A91255541C0C325BED5B83E4DC03C8D2804095541C06B86EE4A963E4DC00C95297AE85441C056BFE5338D3E4DC03D5B07FAE55441C00754E2BA333E4DC07273884BCB5441C02A0A7224F83D4DC0E4C7A2C2A55441C0CB53DFE09F3D4DC0D66F5F8A6C5441C04D11B2514E3D4DC07CF68FF2375441C0653AD542493D4DC0EAE9F6AE345441C034EF4818383D4DC0040D6457425441C0C3EB23A62B3D4DC0A62D0E204C5441C0D83BDAB5113D4DC08376F485605441C025F3C782EB3C4DC016F85E927E5441C0352537B4D13C4DC03F9B29DC925441C09438A08BB83C4DC008FB5289A65441C0531ECD8CA43C4DC081C06337B75441C0F575A1647B3C4DC031196BC0D55441C0DF1EE9FA643C4DC007A9A884A35441C01DA230153A3C4DC0A9469E68435441C0532064952C3C4DC07E178D01515441C09158C7AF243C4DC0E1C72559565441C0A40B70751E3C4DC0A1832DBD5A5441C0379630651A3C4DC0DB84CB8E5D5441C025E00C22DC3B4DC086EF9574295441C0BC9584E8CC3B4DC0CC8AAFFE355441C0F917648DC13B4DC0E84C65893E5441C007D47D3FB13B4DC0093BABED4A5441C0A3675A67AA3B4DC08D3E1C77505441C06BD3E57F9C3B4DC06ACF31EE5A5441C011DD72778B3B4DC0AE50B80B685441C04EFF268D843B4DC0CFB665946D5441C0B3AF67947E3B4DC0C89AC582725441C0CC116029723B4DC0C292A0C07C5441C0","VILLA LUGANO",10870.0189848,4771793.77497,42538,21474,21064,8,19
88,"0106000020E610000001000000010300000001000000530000008D6064E0E63C4DC0311A7850505741C019A265D7E43C4DC023A920E2515741C043B92654E03C4DC0C9083C5D555741C0107FFC57DE3C4DC05E1B14E5565741C0F30EFF8FC23C4DC01396C64C6C5741C0FC0CA553C03C4DC0B91887066E5741C07B42C3D2993C4DC0A9C214C48B5741C028359580943C4DC077D90FE48F5741C05DA53EB2783C4DC0DFDA057CA55741C0E3AC2953743C4DC0BB9AB56FA85741C0C50B6693703C4DC01D5535F7AA5741C0F41B47A54E3C4DC075E25927C55741C0777C90B5263C4DC03B002A1EE55741C07F79C32A003C4DC03A77C411035841C019101C89DC3B4DC05182CC851F5841C099C9DC1CB63B4DC02A714A283D5841C02816B9B8903B4DC0AE11C3955A5841C03A829E84673B4DC05FF399AC7A5841C087523771503B4DC01E86AE448C5841C06DCB2F76243B4DC0CD8EA464635841C0D91AC91AF63A4DC09D954880395841C0BF85B3E1B93A4DC0BDC84F84025841C089DCB24DB93A4DC0FD076AC0015841C06339C303AC3A4DC09A439530F05741C01CBEE6B37E3A4DC00724D1BBC65741C05007D5137C3A4DC01591E154C45741C0AF925A6C633A4DC0DC36101BB35741C0AECF7353623A4DC00137EC00B25741C0EF0823E4043A4DC0766F2E7D5C5741C01703BCA4033A4DC0BE98CA445B5741C0A26ECBFEBD394DC013EA6B1A1B5741C0A3B4ED4AC0394DC05C5ABC7B1E5741C09942E778C0394DC0D9EC7205215741C01C9EEE62BF394DC04412BD42235741C00089B794BD394DC0AFF40A0D255741C02AFD9BF4BB394DC0E2FD2AF2255741C07F6B9A3EB9394DC00BBFE08A265741C0F06CA588B6394DC0AB8A0065265741C048F49176B3394DC0DD36BF7F255741C0AA869D20AF394DC022355ECF225741C0EF4AA091A3394DC09E123F4E185741C03DA0FABE9D394DC0DC7C355A185741C01FB5C19D99394DC00988B272195741C0E76ADDD796394DC0DA22A8F91A5741C012491B2A93394DC04173F57D1D5741C044500B9391394DC0B0F01EC01E5741C0CB7E371D91394DC08012261D1F5741C0DE9121A46A394DC0CA9356813D5741C00E5A22C2DE384DC036A1CED0AB5741C08CC018B8FB3A4DC04C092B8B285A41C0DE0506D2FF3A4DC0B12C33E72D5A41C0BEFD4BCF043B4DC04350E47B315A41C0872B51A5093B4DC085B2D082355A41C09383A9380B3B4DC0CC8D893F375A41C0517B4A7E193B4DC05A5DC00B475A41C03DCD7AB21A3B4DC041D71528465A41C0B3525D8AB73D4DC0F3AC77274D5841C0D1A32196DE3D4DC0951940AA2F5841C0D0D80130B13D4DC08FE64019075841C0DF522713AF3D4DC02F9CEA26055841C0D64951F6AC3D4DC0AB848F34035841C09C3D3B3E983D4DC0B95B3E67F05741C09154A823963D4DC0AB8FBA7EEE5741C0200CDB09943D4DC0B2E2F496EC5741C08B3F07487F3D4DC017A9CADED95741C0A7DAD13B7D3D4DC07B179A01D85741C0ADF9DC2E7B3D4DC071066D24D65741C0835C5844663D4DC0D69AEC47C35741C0B4C42438643D4DC0A9706C62C15741C0B2B1312B623D4DC069DEE97CBF5741C05F04C5624D3D4DC0DFD85FBFAC5741C0017E8E534B3D4DC039A8BAE6AA5741C0028B5944493D4DC059A0530DA95741C0D888C35A343D4DC09D20C952965741C0E480944E323D4DC0C3CBCA6E945741C0786A6B42303D4DC057588F8B925741C00808A09D1B3D4DC087815CC37F5741C09E0FDA80193D4DC0920A29E67D5741C00A8CD264173D4DC03BCBBA097C5741C02F179593023D4DC0C4309E4D695741C01C970573003D4DC0D0B00A62675741C0907CB951FE3C4DC0E5DC7B76655741C08D6064E0E63C4DC0311A7850505741C0","VILLA RIACHUELO",10602.867545,4224142.28009,15703,8274,7429,8,35
87,"0106000020E610000001000000010300000001000000BF0000006B2001579C394DC0EBF60D64595341C02B5370716E394DC0AB8ACA81595341C0FD5C52B66C394DC071D9CE6B595341C066E0FCCA35394DC04CB2EBA9565341C0894E9D4FF5384DC017905B2F545341C0891D6D02E9384DC05CEA0244525341C0F5297A13E2384DC0AA7CD55F565341C07AFA5B10D3384DC0E310E5D4575341C05BD250C7C8384DC0FEA6A69A585341C089D2BA7DC4384DC0C3D9E9EC585341C0B4B95C46BE384DC0566F94A25A5341C0216DE3FFBD384DC0147A102A5F5341C0CC5EBED4BB384DC04008E95D645341C036DAF8FBBA384DC0A78D8468665341C090E3C421B4384DC0F72A2198705341C0DDC6AABE87384DC06D1D71C4925341C09A602D6484384DC02188FA69955341C040F4277060384DC03B2516C9B15341C0DA76DF895F384DC08C139F84B25341C0D8C0357D2D384DC0EE6B8948D95341C01A9E164A23384DC0AB745727E25341C0808591391E384DC03366C9C9E65341C0993229A810384DC029E6B98BF15341C0532DDF8A0F384DC0C882818AF05341C0C77C3DD2F2374DC0F48E6B85DA5341C0FB8EBB60CF374DC09E91C373C25341C08BDBB142CE374DC0B16D1896C15341C0F3D914659B374DC0FD42571D9A5341C00B6E84EF94374DC0705B503B9E5341C0F8E8AD7D71374DC0BE24B8D6B75341C051EE6DEA4D374DC014D380E6D15341C0189D125033374DC0706BA242E55341C03E6AF34CFE364DC03348E7550B5441C035E2A807E5364DC0CFA3F3811D5441C0ED285DF0C9364DC0C70750F5305441C085D394C7AE364DC062D13E76445441C0CCD358F3A3364DC0366300494C5441C0FAECA5C6A0364DC0FFEAE6D54F5441C036586C169B364DC013D42031565441C08C861FA795364DC0BDE549805C5441C047CDEEA392364DC0EB30D1FE5F5441C01EE04E917F364DC074E36B86775441C0B29EF2FD68364DC070818E62935441C0031E26CA46364DC00E6DA63ABE5441C0E7FE05B861364DC082309F7BCF5441C0684CA0A281364DC0E02BD7E7E75441C0F37B3AB492364DC07224A160F75441C0F667DC0DA6364DC0E919E85F0A5541C049DAB3E4B4364DC093D2F1BF1A5541C0D43E8070C5364DC0A1420B6E2D5541C0C4A175B0DB364DC00FB38504485541C0ACF69E84F1364DC0F5A3B3EA615541C0EAE02EC00C374DC077383570825541C0C61872E522374DC0245197859B5541C0323A67353B374DC0B364DE92B85541C001BBCC3256374DC0E28C1590D85541C088971F7373374DC0603A0073FC5541C0328556237D374DC011D1C6A8065641C0004DCAA97F374DC05C23CB50055641C09233AE0483374DC02C1AF03E095641C0904C7DA880374DC0603C97E50A5641C0DE09A65AA2374DC0ACEB63D3325641C0F8169738CC374DC00BF24163645641C08FDAEF0A3C384DC0DA63F555E95641C09FCA27E050384DC04C9F6BFC015741C0A679D0B366384DC01C2AF187065741C00B64F9A369384DC0FCDAA3DB055741C09475747B7E384DC09ABDFC000A5741C08451281C7E384DC083F19B650C5741C0A0FEDCC587384DC0C1C0E1120E5741C0B666C5749C384DC00E0D6160275741C0466FC11B95384DC0AB2B3475565741C00E5A22C2DE384DC036A1CED0AB5741C0DE9121A46A394DC0CA9356813D5741C0CB7E371D91394DC08012261D1F5741C044500B9391394DC0B0F01EC01E5741C012491B2A93394DC04173F57D1D5741C0E76ADDD796394DC0DA22A8F91A5741C01FB5C19D99394DC00988B272195741C03DA0FABE9D394DC0DC7C355A185741C0EF4AA091A3394DC09E123F4E185741C0AA869D20AF394DC022355ECF225741C048F49176B3394DC0DD36BF7F255741C0F06CA588B6394DC0AB8A0065265741C07F6B9A3EB9394DC00BBFE08A265741C02AFD9BF4BB394DC0E2FD2AF2255741C00089B794BD394DC0AFF40A0D255741C01C9EEE62BF394DC04412BD42235741C09942E778C0394DC0D9EC7205215741C0A3B4ED4AC0394DC05C5ABC7B1E5741C0A26ECBFEBD394DC013EA6B1A1B5741C00D5C5B03BD394DC0CF8134321A5741C0B564E2B5B5394DC0FECB9378135741C016BDCDB6B2394DC0308E0AFF0F5741C03D4EDA79AE394DC05E1D5F140B5741C0E7B473C2B0394DC08BC2EDD2075741C048D46BD5B2394DC0A58F5FDC045741C064C5D0472B3A4DC0D3EAFC49A65641C038CAFD73AA3A4DC04182A021435641C0570B4056B63A4DC01FB3A48C3E5641C020BD9303C33A4DC020FEAB3D3D5641C05D02208FC83A4DC088AB9D423C5641C0CAD13685CC3A4DC0DE3B9E9F3A5641C0F855731BCE3A4DC096F17AF8395641C044C9E18BD23A4DC0D387351B365641C052A7A8DCD33A4DC0B7069FD8335641C0DC07BEA1D53A4DC0C93058CE305641C0D41EE46CD63A4DC09D904CE52B5641C0FFE7B932D93A4DC08D4B17B2245641C09F8591F8DA3A4DC04794630F205641C062C16093DB3A4DC05A78BF7A1E5641C0922AF41EE13A4DC0C7929147175641C070CF327F093B4DC0AC0C78F1F45541C0E63F70810A3B4DC071885B12F45541C0A48C1244103B4DC01434B51BEF5541C0AD7251161D3B4DC0B0E3C931E45541C09933DC6C253B4DC0A6C46354DC5541C0A5CBD7402B3B4DC06BA3D5D4D65541C0E1E67D352C3B4DC07F428CA5D55541C076084B3B323B4DC06BD1022FCE5541C04ABE4E53363B4DC0B25F5F1CC95541C060BC07A7383B4DC0A47D41CDC55541C05024268D3D3B4DC0CC2B4CD7BE5541C0D0F36F35403B4DC0007EEE0FBB5541C0C8E3ACE24A3B4DC0CB538D52AE5541C04DE09D83593B4DC0F35422CFA65541C0032CD451693B4DC0447F6BE3A25541C02308E6977D3B4DC04C6E0BDC9D5541C0D5EA8EC4E53B4DC0D14EAD094C5541C0AEC09917FD3B4DC0BB1C59523A5541C0702FE4C9263C4DC0778720CB195541C0897DA3402E3C4DC035283DF8135541C0054C8FF4343C4DC0EAC476530C5541C027C9CC74363C4DC0DD6419130A5541C05236D264373C4DC065A6960C075541C0EE778D65373C4DC07F318D09075541C03048F5F4373C4DC0D7BEA8A5045541C0714F9411383C4DC03F8F0F09025541C07C3EFDA0373C4DC047422702FE5441C0EF354318373C4DC091A03D33FA5441C0DBF96EC7353C4DC0340EC95FF65441C0F1216665323C4DC0CEF4EA63F35441C008F845FA2F3C4DC0312CCBE9F15441C0B739E3DC2E3C4DC07698163BF15441C0AC9B25992A3C4DC052638E9BF05441C0F3E3AB0D273C4DC08E5E87AEF05441C03C30B22D223C4DC0F6168C1EF15441C07D592E931D3C4DC068EB0C60F25441C0868BDF8E1A3C4DC0A225DB1FF45441C0DDB13413183C4DC01FD22AE1F55441C065E7D443143C4DC09C02D15EF85441C0EC11A6E5103C4DC01E74813FF95441C05BB41B9E0D3C4DC06EA1632DF95441C07BEB3436083C4DC0EA03C6BCF85441C0DFF8F456033C4DC06A2A5BEEF75441C08456E4BAFE3B4DC04B3CDEFAF65441C052181F4CFA3B4DC0B123CF4BF55441C0E35D4E1EF53B4DC0BA223917F25441C096C2EB6BE83B4DC013E93231E75441C0F123D438B73B4DC0E26926F4BC5441C080BF909B933B4DC0A6A57CD09D5441C0DBEB7EAE923B4DC0D13C7AE19C5441C0803C1DDF753B4DC03DC7A9D07F5441C0F97A2CF8733B4DC0CBB7083F7E5441C0CC116029723B4DC0C292A0C07C5441C0736AED74663B4DC03A006414735441C0A6FBEE4F663B4DC08E07D4F5725441C0C87602D4163B4DC0ABCA9F5B365441C06E0D74C0153B4DC08C8F5789355441C037B03619ED3A4DC0FB0337E1125441C0523295B7C53A4DC04E3D8956F25341C07FFBC2C3C43A4DC00163703FF15341C0498E45A2BF3A4DC0DFC0CE62EB5341C05EBC4B21BE3A4DC0936D1BACE95341C06D80B5F6923A4DC04631123FC65341C0CE3FBC97823A4DC02392B9F9B75341C06C7624207E3A4DC0C361AFCAB35341C09E894314603A4DC04811886E9A5341C0611E82034D3A4DC0E49F2A578A5341C0C68CA69D453A4DC01B8F3F08845341C093395B043F3A4DC03DB64A677E5341C0BC9511263B3A4DC01B96FE387A5341C0301BC42F373A4DC06F6BCA746F5341C019EA8808373A4DC007C6B9606E5341C098484F31343A4DC03B22E2955A5341C078E3980D323A4DC082F5BF344E5341C067CD6EF7053A4DC0BCBACF72525341C0770BF940FB394DC0C1602869535341C073BD71F5DB394DC05B6A4B39565341C09BE02EBCDA394DC0EC5B4255565341C06B2001579C394DC0EBF60D64595341C0","VILLA SOLDATI",12542.9950616,8660350.14318,28726,14869,13857,8,36
95,"0106000020E6100000010000000103000000010000001E00000051B5CA395B414DC0558D4BF6295341C0FD665DD25A414DC0596EF0C5295341C00DF712B8D4404DC099E86345EB5241C0D2677E45D0404DC070F4C329E95241C0203F82588F404DC03CEAE164CA5241C09FB1793C4B404DC06B692FF6A95241C02BD260D0A13F4DC0B972604A5B5241C0CB478B41663F4DC00C2EE9FC895241C0AB03EBD00F3F4DC01C92DB2ACE5241C02609EF1DA53E4DC013E09192225341C0099E457CD93E4DC0A7928CFD4E5341C0EE806D860D3F4DC01F17D1AF7A5341C01433F521413F4DC0CEFF24AAA55341C04194CC775D3F4DC00F110F4EBD5341C0D771000EA73F4DC049DB8D6DFA5341C0DD19BB38D93F4DC0AD96AC36245441C00050BA12F93F4DC079A633F43E5441C0064FD23E38404DC0989FA29F0B5441C075379CBE54404DC0D9658AC6EE5341C0D998BBB672404DC0D59A884CD05341C0EAC3053B8E404DC0A14BA612B55341C06B094D7A9C404DC020F83972A65341C076F6B2F1BA404DC05CBDF727945341C0F36D6598EB404DC08A0E014C775341C0BF1456F90E414DC0014C27F1605341C08EF0464836414DC0A37BD7E5445341C0767D77265A414DC008ACC64A2B5341C0C4F65E325B414DC03E1DCBC42A5341C09283B30B5C414DC0B956CA572A5341C051B5CA395B414DC0558D4BF6295341C0","MATADEROS",5124.717227,1558677.17613,16293,8065,8228,9,18
96,"0106000020E6100000010000000103000000010000001C0000002609EF1DA53E4DC013E09192225341C09E5FDD893E3E4DC0239559B6735341C0F498057D3E3E4DC033E02EC0735341C0B8E2B534F03D4DC0B0EAD477B05341C0ABAD62C2493D4DC034605C4A345441C0653AD542493D4DC0EAE9F6AE345441C04D11B2514E3D4DC07CF68FF2375441C0CB53DFE09F3D4DC0D66F5F8A6C5441C02A0A7224F83D4DC0E4C7A2C2A55441C00754E2BA333E4DC07273884BCB5441C056BFE5338D3E4DC03D5B07FAE55441C06B86EE4A963E4DC00C95297AE85441C0C325BED5B83E4DC03C8D2804095541C06CF7957CD73E4DC0368E3A91255541C01A300044D93E4DC0B8F26B55275541C0927D63FF183F4DC00F6D3A47F55441C02F8D51EA483F4DC0FD8FB0DCCD5441C0145F9EAB903F4DC046E18829945441C07A13E33AB83F4DC05BDF98A7735441C0DF4D1BBAF13F4DC0ADA4D8EB445441C00050BA12F93F4DC079A633F43E5441C0DD19BB38D93F4DC0AD96AC36245441C0D771000EA73F4DC049DB8D6DFA5341C04194CC775D3F4DC00F110F4EBD5341C01433F521413F4DC0CEFF24AAA55341C0EE806D860D3F4DC01F17D1AF7A5341C0099E457CD93E4DC0A7928CFD4E5341C02609EF1DA53E4DC013E09192225341C0","MATADEROS",5230.86940568,1678268.75973,11962,6179,5783,9,18
97,"0106000020E610000001000000010300000001000000300000001A300044D93E4DC0B8F26B55275541C077A862D6EC3E4DC08DA200C23A5541C0FAB5CB63F23E4DC021FA4547405541C06FD1516FF73E4DC095CFFF4B455541C0BA6C8941FF3E4DC01027E2064D5541C07F46FC2A023F4DC0120CD9E24F5541C0402C365F053F4DC032599900535541C048B5C41B2B3F4DC0B7F252EF7C5541C0ABF71DAC2E3F4DC0215D3EEA7F5541C00AAE9F79313F4DC0748B9942825541C089925E07733F4DC0A965289DC35541C08D5CEE53783F4DC08B21867DC85541C088E40F939F3F4DC0011DE810EA5541C018FACA2BA43F4DC0261BE85BED5541C0AFDF86E0AA3F4DC0B7313C29F25541C04666E90BB33F4DC0DBA02BFFF75541C0BF1EC67CBB3F4DC012FE3400FE5541C0986A4089C43F4DC0C4FCDC6E045641C04F9B6B95D73F4DC03DE8E506125641C004AFDFBCDC3F4DC0A3A5924F155641C0BCE09230E23F4DC0536E4D4A185641C017B10890ED3F4DC0415507611E5641C02B3FFB81F73F4DC0104C36B6235641C02F611FD2FA3F4DC00C99477D255641C0D7D49B2700404DC0D846855A285641C064B8F7B703404DC091ACD6422A5641C0785B9AEB0C404DC05E0375302F5641C099C2195416404DC069794036345641C0FCAD6E8026404DC079D747D93C5641C016DFB6C452404DC02BB2D84B565641C028D8CBD884414DC0A5C6FF666E5541C0C62A947753414DC0E13C3B91455541C01508152F01414DC0420C6A55005541C03E632B20A9404DC071B2F246B75441C02A465F9D7E404DC05E64F9F0935441C047FD2CAC5F404DC0C781EF277A5441C0E5697C5C51404DC0482B15AB745441C0ADE4E8E742404DC03D5A42E56F5441C0EA5353AB2E404DC04E04837F685441C06F8A5F8622404DC011F19455615441C038CA168315404DC0516A4BD4565441C00050BA12F93F4DC079A633F43E5441C0DF4D1BBAF13F4DC0ADA4D8EB445441C07A13E33AB83F4DC05BDF98A7735441C0145F9EAB903F4DC046E18829945441C02F8D51EA483F4DC0FD8FB0DCCD5441C0927D63FF183F4DC00F6D3A47F55441C01A300044D93E4DC0B8F26B55275541C0","MATADEROS",5291.79023095,1805659.8415,13763,7036,6727,9,18
98,"0106000020E61000000100000001030000000100000020000000615460894C434DC03A3D5B0A155441C0D4BEE83C30434DC0EEBE9B15045441C0FB190FB70E434DC033594852F45341C08995926EDC424DC0068CCE44DD5341C0DD7EACD069424DC0BFF321E1A75341C04A2CAFEA83414DC058BF82F43C5341C046740B7D5D414DC0F799D9D42B5341C09283B30B5C414DC0B956CA572A5341C0C4F65E325B414DC03E1DCBC42A5341C0767D77265A414DC008ACC64A2B5341C08EF0464836414DC0A37BD7E5445341C0BF1456F90E414DC0014C27F1605341C0F36D6598EB404DC08A0E014C775341C076F6B2F1BA404DC05CBDF727945341C06B094D7A9C404DC020F83972A65341C0EAC3053B8E404DC0A14BA612B55341C0D998BBB672404DC0D59A884CD05341C075379CBE54404DC0D9658AC6EE5341C0064FD23E38404DC0989FA29F0B5441C00050BA12F93F4DC079A633F43E5441C038CA168315404DC0516A4BD4565441C06F8A5F8622404DC011F19455615441C0EA5353AB2E404DC04E04837F685441C0ADE4E8E742404DC03D5A42E56F5441C0E5697C5C51404DC0482B15AB745441C047FD2CAC5F404DC0C781EF277A5441C02A465F9D7E404DC05E64F9F0935441C03E632B20A9404DC071B2F246B75441C01508152F01414DC0420C6A55005541C0C62A947753414DC0E13C3B91455541C028D8CBD884414DC0A5C6FF666E5541C0615460894C434DC03A3D5B0A155441C0","MATADEROS",6223.31573429,2355961.27413,22042,11265,10777,9,18
91,"0106000020E61000000200000001030000000100000004000000EE778D65373C4DC07F318D09075541C05236D264373C4DC065A6960C075541C0DCC69165373C4DC01182520A075541C0EE778D65373C4DC07F318D09075541C00103000000010000003100000037B03619ED3A4DC0FB0337E1125441C06E0D74C0153B4DC08C8F5789355441C0C87602D4163B4DC0ABCA9F5B365441C0A6FBEE4F663B4DC08E07D4F5725441C0736AED74663B4DC03A006414735441C0CC116029723B4DC0C292A0C07C5441C0B3AF67947E3B4DC0C89AC582725441C04EFF268D843B4DC0CFB665946D5441C011DD72778B3B4DC0AE50B80B685441C06BD3E57F9C3B4DC06ACF31EE5A5441C0A3675A67AA3B4DC08D3E1C77505441C007D47D3FB13B4DC0093BABED4A5441C0F917648DC13B4DC0E84C65893E5441C0BC9584E8CC3B4DC0CC8AAFFE355441C025E00C22DC3B4DC086EF9574295441C0379630651A3C4DC0DB84CB8E5D5441C0A40B70751E3C4DC0A1832DBD5A5441C09158C7AF243C4DC0E1C72559565441C0532064952C3C4DC07E178D01515441C01DA230153A3C4DC0A9469E68435441C0DF1EE9FA643C4DC007A9A884A35441C0F575A1647B3C4DC031196BC0D55441C0531ECD8CA43C4DC081C06337B75441C09438A08BB83C4DC008FB5289A65441C0352537B4D13C4DC03F9B29DC925441C025F3C782EB3C4DC016F85E927E5441C0D83BDAB5113D4DC08376F485605441C0C3EB23A62B3D4DC0A62D0E204C5441C034EF4818383D4DC0040D6457425441C0653AD542493D4DC0EAE9F6AE345441C0B51EB093473D4DC02C75FA43335441C0C130A0DD353D4DC06E597E57245441C0A6D37012FF3C4DC09DF74F0CF25341C0D28D4AEF6A3C4DC0B6820F166B5341C09AA507F71A3C4DC0102D8990225341C03490C18D0A3C4DC09DCA37922F5341C0A03E7391C13B4DC01383358A685341C0FBD5F8E2BA3B4DC04784DAED6D5341C00A5438C1B83B4DC04FF4B410705341C0150BAD61AE3B4DC023CF69797A5341C082B2DFADA03B4DC0DEFB1E82865341C0475B8F549B3B4DC0D0B402348B5341C0AF914C9B773B4DC09B233640A75341C0F5A67DF5633B4DC05F7CC1CBB35341C083D9B589593B4DC05B733AEABB5341C0ABDD2D59313B4DC09896E1E9DA5341C0F123D04C103B4DC0AFF75B2CF95341C06986E8DA0E3B4DC0D61C5F3AFA5341C037B03619ED3A4DC0FB0337E1125441C0","PARQUE AVELLANEDA",5050.80160726,1115988.67321,7415,3822,3593,9,31
92,"0106000020E6100000010000000103000000010000001C0000001A8C85E6403D4DC091E3C30F895141C0040F0E24073D4DC09A4DF15AB65141C09D921CEDEF3C4DC0A99830C5C85141C0154823F09A3C4DC06BBFE16A935141C0FEE7A5FF533C4DC0CC888AAA7D5141C04781B36A113C4DC0A03FE61D185241C0E3D456BD883B4DC07EEA3957855241C06DC19C60873B4DC0E58D576E865241C023C4F6AF803B4DC014DBDA608A5241C05D1924F57C3B4DC09A631A958C5241C0AC6C2CF6673B4DC0DEC1C2159C5241C0873C407F513B4DC0EC55114DAD5241C043D06135433B4DC010B1D8E9B55241C067FA5E4E503B4DC07ECCEC0DCC5241C0E2110AAE603B4DC062BFA26CE35241C057B221B8733B4DC051D29E74F75241C00745E0BEA33B4DC01A99ABAC325341C028CE593EA53B4DC04E059F84345341C0197C4717C73B4DC069EA5616645341C0A03E7391C13B4DC01383358A685341C03490C18D0A3C4DC09DCA37922F5341C09AA507F71A3C4DC0102D8990225341C0C9E56CA69E3C4DC0D57EBD30BA5241C0C73EFA380E3D4DC0D28C0F27625241C051844DE86D3D4DC0C93FC671155241C02ABA40A1723D4DC0FCDAB5A8115241C003C1BCCBCE3D4DC0A50AA657C95141C01A8C85E6403D4DC091E3C30F895141C0","PARQUE AVELLANEDA",5369.97151577,1238087.62686,13283,6587,6696,9,31
93,"0106000020E6100000010000000103000000010000000F000000ABAD62C2493D4DC034605C4A345441C0B8E2B534F03D4DC0B0EAD477B05341C0F498057D3E3E4DC033E02EC0735341C0BE089D4F9F3D4DC0D59AC9C8EA5241C09EB63DBF053E4DC0ADC802C5975241C051844DE86D3D4DC0C93FC671155241C0C73EFA380E3D4DC0D28C0F27625241C0C9E56CA69E3C4DC0D57EBD30BA5241C09AA507F71A3C4DC0102D8990225341C0D28D4AEF6A3C4DC0B6820F166B5341C0A6D37012FF3C4DC09DF74F0CF25341C0C130A0DD353D4DC06E597E57245441C0B51EB093473D4DC02C75FA43335441C0653AD542493D4DC0EAE9F6AE345441C0ABAD62C2493D4DC034605C4A345441C0","PARQUE AVELLANEDA",5174.73238553,1415925.53077,8100,4015,4085,9,31
94,"0106000020E61000000100000001030000000100000010000000F498057D3E3E4DC033E02EC0735341C09E5FDD893E3E4DC0239559B6735341C02609EF1DA53E4DC013E09192225341C0AB03EBD00F3F4DC01C92DB2ACE5241C0CB478B41663F4DC00C2EE9FC895241C0D0069BA65E3F4DC047FF0922875241C011ED9BEE5A3F4DC079CDD64B855241C01D504EBC573F4DC0CAC7B98F845241C04F8D1E73703E4DC0329EEA08165241C0A63A98EDCF3D4DC0FE2235DBC95141C003C1BCCBCE3D4DC0A50AA657C95141C02ABA40A1723D4DC0FCDAB5A8115241C051844DE86D3D4DC0C93FC671155241C09EB63DBF053E4DC0ADC802C5975241C0BE089D4F9F3D4DC0D59AC9C8EA5241C0F498057D3E3E4DC033E02EC0735341C0","PARQUE AVELLANEDA",4489.62863074,960440.574822,10740,5222,5518,9,31
99,"0106000020E610000001000000010300000001000000120000009283B30B5C414DC0B956CA572A5341C046740B7D5D414DC0F799D9D42B5341C04A2CAFEA83414DC058BF82F43C5341C0DD7EACD069424DC0BFF321E1A75341C08995926EDC424DC0068CCE44DD5341C0FB190FB70E434DC033594852F45341C0D4BEE83C30434DC0EEBE9B15045441C0615460894C434DC03A3D5B0A155441C010F3ED6DB4434DC03B50979FC65341C0896D1EC1FE424DC0924948131C5341C0E5BEF1E899424DC0CEA8B668BD5241C0255D2C6848424DC043BAB722775241C03ABF6D0848424DC0BC94E5C6775241C019AA8F1701424DC065B28564AE5241C078309047B1414DC0864D89B6EA5241C0DAE20AF67D414DC09DED3206115341C04DD64FA268414DC0321114F2205341C09283B30B5C414DC0B956CA572A5341C0","LINIERS",4418.28600347,982914.704591,10987,5457,5530,9,39
100,"0106000020E6100000010000000103000000010000001B000000DAE20AF67D414DC09DED3206115341C078309047B1414DC0864D89B6EA5241C019AA8F1701424DC065B28564AE5241C03ABF6D0848424DC0BC94E5C6775241C0255D2C6848424DC043BAB722775241C0741A4CC957424DC0676F45E25C5241C05BDC475A5F424DC0E8270AD41B5241C0E494BB8B5F424DC0C23192C2195241C0B89E8A5964424DC038B5FBB1E65141C0B97179D167424DC0008A136AB85141C058FA6DD157414DC0810CC7AA955141C0CCFD6DD156414DC03B1C81CB995141C00624FFCE49414DC0BAC77C7CCF5141C0FD53131A41414DC077ACDA13EE5141C04A9E1FE7BA404DC0CC858A59545241C05473DBEF7D404DC0778F1ACE815241C0AF59F3E86C404DC05750DBDA8E5241C050E8957667404DC06D93BB3D935241C09FB1793C4B404DC06B692FF6A95241C0203F82588F404DC03CEAE164CA5241C0D2677E45D0404DC070F4C329E95241C00DF712B8D4404DC099E86345EB5241C0FD665DD25A414DC0596EF0C5295341C051B5CA395B414DC0558D4BF6295341C09283B30B5C414DC0B956CA572A5341C04DD64FA268414DC0321114F2205341C0DAE20AF67D414DC09DED3206115341C0","LINIERS",4446.49039697,1159512.40057,12660,6167,6493,9,39
101,"0106000020E6100000010000000103000000010000004500000010F3ED6DB4434DC03B50979FC65341C06879C51BBD434DC02E3A4F12C05341C00C885CCEE2434DC0BBB2FBF8405141C0D85C4DCECA434DC0EF3822B1415141C091FDC118C3434DC052F4B2EB415141C0CA28141FB3434DC0A4A07BC5425141C05E6E3AEEAC434DC0B7284F1A435141C033252345A7434DC06C4183F4425141C0E10930CA9B434DC06705F3A8425141C00802A3CF94434DC0B443D80E425141C08A73984877434DC038A9DF833F5141C04AF844E871434DC08A7A20353D5141C0A784CAD727434DC0DCB7E84D375141C0E5AB1C1C25434DC07C91C011375141C03FBE90F819434DC0BE0733E9355141C0D04003FBF3424DC01A9E0F662C5141C06F1A5C18DA424DC048E93D07275141C05B999EE0C0424DC0FA716051235141C04491A772B2424DC0170F0B2E215141C0235ADFEEA5424DC09710D612215141C0AEE729F7A8424DC0AF58CAE1165141C003D0111CAA424DC05DADA609135141C07C0104BDA7424DC0241C65520D5141C0C688AF7FA0424DC00312A62D065141C05E2824E69B424DC07E5F7503055141C06C052E3597424DC083FCF685FF5041C06252152A95424DC071DA2236035141C0B03AD36E91424DC09C376E6A045141C0F82109FE85424DC0E88543B0055141C032F5168977424DC07E132175065141C0AE419E3B6B424DC09EF07DF4055141C0340BB98A67424DC0E547EDF4055141C0C15ED88963424DC028950B06065141C0DB6A392A58424DC09012C637065141C01202F1DE2F424DC0C065797D065141C0F713C5B71E424DC0C36F7F52095141C0C395067E1C424DC06CEA8AB0095141C0AAF6FD3C09424DC0BF6B3A5D095141C0167915E107424DC07BEB3383095141C0229AF204E7414DC09696BE170D5141C07EA5E521CE414DC00DDC9C1A135141C0D8096B02B7414DC0990E88E11A5141C0BA997BBF9D414DC04E258DFB255141C016C2E8726A414DC065AB82D23B5141C0AD6135745D414DC06E2708BE415141C04F1006645B414DC09BB4AB86425141C0AEC207D03A414DC0C1250D34505141C078461BF331414DC0D01DA6EB535141C05C7E4B8617414DC06E093E5D5D5141C0A74934B615414DC00406AFD55D5141C01923040DFD404DC00ACBBC36645141C04C8F50B1FA404DC0ADC8C2D2645141C0D76FABDCE3404DC085F3E5D4645141C0D34727A8DF404DC0123103D9625141C0F9EC5A6DBD404DC059B0E8AD7C5141C004CFEDA0B9404DC073AA45F17F5141C065888A3BBB404DC09C485728805141C00DFCB09532414DC0D1EAC500905141C0A02141E457414DC0CD9F615E955141C058FA6DD157414DC0810CC7AA955141C0B97179D167424DC0008A136AB85141C0B89E8A5964424DC038B5FBB1E65141C0E494BB8B5F424DC0C23192C2195241C05BDC475A5F424DC0E8270AD41B5241C0741A4CC957424DC0676F45E25C5241C0255D2C6848424DC043BAB722775241C0E5BEF1E899424DC0CEA8B668BD5241C0896D1EC1FE424DC0924948131C5341C010F3ED6DB4434DC03B50979FC65341C0","LINIERS",8092.2371932,2231801.26078,17992,8968,9024,9,39
104,"0106000020E6100000010000000103000000010000000D00000097E2BDC772404DC0B809BD31E04F41C0A20505D1EE404DC04493F926555041C0C77CA79F10414DC08311EEDD3B5041C0DE58141133414DC0FE5A821F225041C0E5B0C56B7D414DC024005A1AE84F41C0FC8DAD8918424DC0865FCED4705041C0300997FEC4424DC017B9CDDCEC4F41C028454E36A6424DC0C34EF7EBD04F41C042115B602B424DC05AFF3540634F41C0AF53D6A0AB414DC0FADB44F1F04E41C0FB772ACD86414DC023851E8D0D4F41C087D3D0260B414DC0102965E96C4F41C097E2BDC772404DC0B809BD31E04F41C0","MONTE CASTRO",4716.07563193,1049457.40423,11788,5696,6092,10,8
105,"0106000020E610000001000000010300000001000000130000006368806106404DC05C83C8A5F74D41C08B9F4F81EA3F4DC0A2B21116174E41C089A05BC46E3F4DC0826F2D7DA44E41C0397ED643553F4DC0C402C9E4B84E41C0F8AB9EA5313F4DC0AF966627D54E41C0C530D59E0E3F4DC0FC19FC18F14E41C048A63A12543F4DC0B6300EB42B4F41C09F35B2E1C43F4DC06A8580FD884F41C020B4C8DE08404DC0D03E3F97AB4F41C01DE43F5772404DC058C41FC7DF4F41C097E2BDC772404DC0B809BD31E04F41C087D3D0260B414DC0102965E96C4F41C0FB772ACD86414DC023851E8D0D4F41C0AF53D6A0AB414DC0FADB44F1F04E41C0BE63C194AB414DC037B1AFE6F04E41C0F4DEE01C63414DC01965901BC64E41C02502EB1CE7404DC07FC6FFE17C4E41C041A0212D94404DC0AD0347944C4E41C06368806106404DC05C83C8A5F74D41C0","MONTE CASTRO",5032.97579825,1576415.07354,17697,8496,9201,10,8
103,"0106000020E6100000010000000103000000010000001100000042115B602B424DC05AFF3540634F41C028454E36A6424DC0C34EF7EBD04F41C0300997FEC4424DC017B9CDDCEC4F41C03AA22E16EC424DC038984AABCE4F41C0D9AD5959F1434DC008FB86AA525041C0EEC29FCE08444DC0C9D7BE7EC84E41C0563A09A4C5434DC08B3624D4314E41C08A42EE54A7434DC0CB1FF0A3454E41C060BBFED884434DC0390746655F4E41C0B1EA1A0884434DC046BD3001604E41C02322C5824A434DC096DC73218A4E41C02DE7580237434DC06C28DD8D974E41C04C20D22F35434DC0839B9762964E41C022D137521B434DC0358B7452AB4E41C0E7AEBF62F5424DC056EBB8EFC84E41C0E61451DDB0424DC029929D34FD4E41C042115B602B424DC05AFF3540634F41C0","VILLA REAL",5071.21209842,1334764.20784,12898,6409,6489,10,9
110,"0106000020E6100000010000000103000000010000000D00000047BD529CBF3E4DC0E1858A93585041C0AD183B34C23E4DC032166E80565041C09F35B2E1C43F4DC06A8580FD884F41C048A63A12543F4DC0B6300EB42B4F41C0C530D59E0E3F4DC0FC19FC18F14E41C08A54BA7FEB3E4DC02D843E2A0D4F41C01DFC44F0813E4DC08224D45C614F41C0FF7DC3C6CA3D4DC00DBD37ECF34F41C0F418BEEBCA3D4DC01CA53008F44F41C061C759EB0D3E4DC0DF3EDDA20F5041C031A7EE52213E4DC09545AC84175041C0B1B31F55953E4DC063B5625C475041C047BD529CBF3E4DC0E1858A93585041C0","FLORESTA",3764.37401368,821638.775419,9846,4706,5140,10,11
111,"0106000020E610000001000000010300000001000000250000005FF92730AF3C4DC038038000B25041C0DB5AFC92CD3C4DC0C1497696BA5041C064DE75CBD33C4DC0E6CB818CBC5041C045CED8CAD73C4DC09E8A1FD0BD5041C0F3081843F53C4DC048E33F51C75041C0EAF9E7F9F93C4DC01A3F66D7C85041C013EA3FCB173D4DC0DDA8950DD25041C0E04EBA553A3D4DC045BEF3B9DC5041C06C16892F5D3D4DC02DA12D7FE75041C06D1D4B5C5C3D4DC08D2F8B2AE95041C0A34512DA893D4DC022B54F4EF75041C05B321AB78A3D4DC0C8BF515AF55041C096D6BFA1B23D4DC00DEC8FD0015141C0F8DD3504B63D4DC01A3278E1025141C0AF19FCF9D43D4DC031F06AA20C5141C0DF915A76DB3D4DC037E1B7AC0E5141C04959BE3BDE3D4DC04CA7454A0C5141C0580BB15DDE3D4DC056F5872D0C5141C0DFE254B9E03D4DC055D8E8310A5141C0C86217D5E83D4DC062B96861035141C022564D9CE93D4DC021734EA7025141C0405766F7EA3D4DC0E3D43496015141C0F2710603383E4DC0512C2602C55041C0C6269373BF3E4DC0F45314B4585041C047BD529CBF3E4DC0E1858A93585041C0B1B31F55953E4DC063B5625C475041C031A7EE52213E4DC09545AC84175041C061C759EB0D3E4DC0DF3EDDA20F5041C0F418BEEBCA3D4DC01CA53008F44F41C0FF7DC3C6CA3D4DC00DBD37ECF34F41C0CB2B20A0A93D4DC09FD9D3FAE54F41C001C71FDF5B3D4DC065855A71C44F41C038D6BEAA2E3D4DC0DF8D596DAD4F41C0B9096DCB283D4DC0D55D1D70AA4F41C086042A1BDC3C4DC02B0837764F5041C0D2FCE703B13C4DC0F1A612FEAD5041C05FF92730AF3C4DC038038000B25041C0","FLORESTA",4035.53592907,957495.077406,13465,6463,7002,10,11
112,"0106000020E6100000010000000103000000010000001F0000007B0C330A543C4DC0E09157927D5141C0FEE7A5FF533C4DC0CC888AAA7D5141C0154823F09A3C4DC06BBFE16A935141C09D921CEDEF3C4DC0A99830C5C85141C0040F0E24073D4DC09A4DF15AB65141C01A8C85E6403D4DC091E3C30F895141C0C9B3B0674D3D4DC01B8A7009805141C090FAB9CF663D4DC0FED235856B5141C01ECAFEBF8D3D4DC0272454EB4B5141C06B2C64AF913D4DC023F0AEE4485141C0EE54D922BC3D4DC053101363265141C06974CBCFD63D4DC0039813AD125141C0DF915A76DB3D4DC037E1B7AC0E5141C0AF19FCF9D43D4DC031F06AA20C5141C0F8DD3504B63D4DC01A3278E1025141C096D6BFA1B23D4DC00DEC8FD0015141C05B321AB78A3D4DC0C8BF515AF55041C0A34512DA893D4DC022B54F4EF75041C06D1D4B5C5C3D4DC08D2F8B2AE95041C06C16892F5D3D4DC02DA12D7FE75041C0E04EBA553A3D4DC045BEF3B9DC5041C013EA3FCB173D4DC0DDA8950DD25041C0EAF9E7F9F93C4DC01A3F66D7C85041C0F3081843F53C4DC048E33F51C75041C045CED8CAD73C4DC09E8A1FD0BD5041C064DE75CBD33C4DC0E6CB818CBC5041C0DB5AFC92CD3C4DC0C1497696BA5041C05FF92730AF3C4DC038038000B25041C081ACFA749B3C4DC0F09B4147DD5041C07E9E43B1733C4DC0B8886D9C365141C07B0C330A543C4DC0E09157927D5141C0","FLORESTA",3067.80447799,542171.088255,8290,3945,4345,10,11
108,"0106000020E610000001000000010300000001000000150000009F35B2E1C43F4DC06A8580FD884F41C0AD183B34C23E4DC032166E80565041C047BD529CBF3E4DC0E1858A93585041C0C6269373BF3E4DC0F45314B4585041C00969ED8C2E3F4DC07AFCE430865041C0C229CED6363F4DC0A53EA4538B5041C06EA7E0CE523F4DC023FBE728985041C094DA71F3563F4DC08C5C1506935041C0FD409A76823F4DC0F02B9AD4B15041C0434F3CD28C3F4DC0E2C4D41BB65041C0BA39B9DCAA3F4DC07156EC84BF5041C069B73BE9E53F4DC014A087E7D45041C01677D016FE3F4DC04491268BDE5041C0E2E4F3D7FE3F4DC06997FF08DE5041C0019397A322404DC07B7F21D9EB5041C011D57DC5EC404DC054535FA4565041C0A20505D1EE404DC04493F926555041C097E2BDC772404DC0B809BD31E04F41C01DE43F5772404DC058C41FC7DF4F41C020B4C8DE08404DC0D03E3F97AB4F41C09F35B2E1C43F4DC06A8580FD884F41C0","VELEZ SARSFIELD",4014.41012735,993115.462317,11216,5422,5794,10,15
109,"0106000020E61000000100000001030000000100000026000000DF915A76DB3D4DC037E1B7AC0E5141C06974CBCFD63D4DC0039813AD125141C0EE54D922BC3D4DC053101363265141C06B2C64AF913D4DC023F0AEE4485141C01ECAFEBF8D3D4DC0272454EB4B5141C090FAB9CF663D4DC0FED235856B5141C0C9B3B0674D3D4DC01B8A7009805141C01A8C85E6403D4DC091E3C30F895141C003C1BCCBCE3D4DC0A50AA657C95141C0A63A98EDCF3D4DC0FE2235DBC95141C04F8D1E73703E4DC0329EEA08165241C0C6E58000F43E4DC0B4948991AE5141C040C51CF6243F4DC0998B563D885141C0B8D0CA761E3F4DC02E398579795141C05855B4E0343F4DC0703FFD9D7D5141C06D6FB94B543F4DC05C735239645141C02B4A98776B3F4DC0DDC6B610525141C0AE058BA0C83F4DC0D3A6190D095141C025729181DE3F4DC068566DD3F75041C0E5A5F945F63F4DC0B8C216D1E35041C01677D016FE3F4DC04491268BDE5041C069B73BE9E53F4DC014A087E7D45041C0BA39B9DCAA3F4DC07156EC84BF5041C0434F3CD28C3F4DC0E2C4D41BB65041C0FD409A76823F4DC0F02B9AD4B15041C094DA71F3563F4DC08C5C1506935041C06EA7E0CE523F4DC023FBE728985041C0C229CED6363F4DC0A53EA4538B5041C00969ED8C2E3F4DC07AFCE430865041C0C6269373BF3E4DC0F45314B4585041C0F2710603383E4DC0512C2602C55041C0405766F7EA3D4DC0E3D43496015141C022564D9CE93D4DC021734EA7025141C0C86217D5E83D4DC062B96861035141C0DFE254B9E03D4DC055D8E8310A5141C0580BB15DDE3D4DC056F5872D0C5141C04959BE3BDE3D4DC04CA7454A0C5141C0DF915A76DB3D4DC037E1B7AC0E5141C0","VELEZ SARSFIELD",5078.35044892,1407835.34933,18865,8993,9872,10,15
106,"0106000020E61000000100000001030000000100000024000000FC8DAD8918424DC0865FCED4705041C0E5B0C56B7D414DC024005A1AE84F41C0DE58141133414DC0FE5A821F225041C0C77CA79F10414DC08311EEDD3B5041C0A20505D1EE404DC04493F926555041C011D57DC5EC404DC054535FA4565041C0019397A322404DC07B7F21D9EB5041C0E2E4F3D7FE3F4DC06997FF08DE5041C01677D016FE3F4DC04491268BDE5041C0E5A5F945F63F4DC0B8C216D1E35041C025729181DE3F4DC068566DD3F75041C0AE058BA0C83F4DC0D3A6190D095141C02B4A98776B3F4DC0DDC6B610525141C00FB03BD5A33F4DC0B966CC49595141C09676ED5AB53F4DC0C4BB39485C5141C0EA633DF3EC3F4DC0ED734341665141C04217F7C40B404DC0219D43BD6A5141C0E81050C35F404DC095D3EBB2765141C02959272DB6404DC059F0CB28805141C065888A3BBB404DC09C485728805141C004CFEDA0B9404DC073AA45F17F5141C0F9EC5A6DBD404DC059B0E8AD7C5141C0D34727A8DF404DC0123103D9625141C0D76FABDCE3404DC085F3E5D4645141C04C8F50B1FA404DC0ADC8C2D2645141C01923040DFD404DC00ACBBC36645141C0A74934B615414DC00406AFD55D5141C05C7E4B8617414DC06E093E5D5D5141C078461BF331414DC0D01DA6EB535141C0AEC207D03A414DC0C1250D34505141C04F1006645B414DC09BB4AB86425141C0AD6135745D414DC06E2708BE415141C06EAF717450414DC08A1B1F5E405141C0E0109FCA12414DC0E1B583A03A5141C0EA828E958A414DC01F0BC97ADE5041C0FC8DAD8918424DC0865FCED4705041C0","VILLA LURO",5317.87519177,1109872.63185,10709,5219,5490,10,16
107,"0106000020E6100000010000000103000000010000001F0000002B4A98776B3F4DC0DDC6B610525141C06D6FB94B543F4DC05C735239645141C05855B4E0343F4DC0703FFD9D7D5141C0B8D0CA761E3F4DC02E398579795141C040C51CF6243F4DC0998B563D885141C0C6E58000F43E4DC0B4948991AE5141C04F8D1E73703E4DC0329EEA08165241C01D504EBC573F4DC0CAC7B98F845241C011ED9BEE5A3F4DC079CDD64B855241C0D0069BA65E3F4DC047FF0922875241C0CB478B41663F4DC00C2EE9FC895241C02BD260D0A13F4DC0B972604A5B5241C09FB1793C4B404DC06B692FF6A95241C050E8957667404DC06D93BB3D935241C0AF59F3E86C404DC05750DBDA8E5241C05473DBEF7D404DC0778F1ACE815241C04A9E1FE7BA404DC0CC858A59545241C0FD53131A41414DC077ACDA13EE5141C00624FFCE49414DC0BAC77C7CCF5141C0CCFD6DD156414DC03B1C81CB995141C058FA6DD157414DC0810CC7AA955141C0A02141E457414DC0CD9F615E955141C00DFCB09532414DC0D1EAC500905141C065888A3BBB404DC09C485728805141C02959272DB6404DC059F0CB28805141C0E81050C35F404DC095D3EBB2765141C04217F7C40B404DC0219D43BD6A5141C0EA633DF3EC3F4DC0ED734341665141C09676ED5AB53F4DC0C4BB39485C5141C00FB03BD5A33F4DC0B966CC49595141C02B4A98776B3F4DC0DDC6B610525141C0","VILLA LURO",5233.49388141,1456865.39309,17390,8421,8969,10,16
102,"0106000020E61000000100000001030000000100000034000000300997FEC4424DC017B9CDDCEC4F41C0FC8DAD8918424DC0865FCED4705041C0EA828E958A414DC01F0BC97ADE5041C0E0109FCA12414DC0E1B583A03A5141C06EAF717450414DC08A1B1F5E405141C0AD6135745D414DC06E2708BE415141C016C2E8726A414DC065AB82D23B5141C0BA997BBF9D414DC04E258DFB255141C0D8096B02B7414DC0990E88E11A5141C07EA5E521CE414DC00DDC9C1A135141C0229AF204E7414DC09696BE170D5141C0167915E107424DC07BEB3383095141C0AAF6FD3C09424DC0BF6B3A5D095141C0C395067E1C424DC06CEA8AB0095141C0F713C5B71E424DC0C36F7F52095141C01202F1DE2F424DC0C065797D065141C0DB6A392A58424DC09012C637065141C0C15ED88963424DC028950B06065141C0340BB98A67424DC0E547EDF4055141C0AE419E3B6B424DC09EF07DF4055141C032F5168977424DC07E132175065141C0F82109FE85424DC0E88543B0055141C0B03AD36E91424DC09C376E6A045141C06252152A95424DC071DA2236035141C06C052E3597424DC083FCF685FF5041C05E2824E69B424DC07E5F7503055141C0C688AF7FA0424DC00312A62D065141C07C0104BDA7424DC0241C65520D5141C003D0111CAA424DC05DADA609135141C0AEE729F7A8424DC0AF58CAE1165141C0235ADFEEA5424DC09710D612215141C04491A772B2424DC0170F0B2E215141C05B999EE0C0424DC0FA716051235141C06F1A5C18DA424DC048E93D07275141C0D04003FBF3424DC01A9E0F662C5141C03FBE90F819434DC0BE0733E9355141C0E5AB1C1C25434DC07C91C011375141C0A784CAD727434DC0DCB7E84D375141C04AF844E871434DC08A7A20353D5141C08A73984877434DC038A9DF833F5141C00802A3CF94434DC0B443D80E425141C0E10930CA9B434DC06705F3A8425141C033252345A7434DC06C4183F4425141C05E6E3AEEAC434DC0B7284F1A435141C0CA28141FB3434DC0A4A07BC5425141C091FDC118C3434DC052F4B2EB415141C0D85C4DCECA434DC0EF3822B1415141C00C885CCEE2434DC0BBB2FBF8405141C099165CFDE3434DC086ED9BE12C5141C0D9AD5959F1434DC008FB86AA525041C03AA22E16EC424DC038984AABCE4F41C0300997FEC4424DC017B9CDDCEC4F41C0","VERSALLES",5650.12164913,1407277.51914,12488,6159,6329,10,40
117,"0106000020E61000000100000001030000000100000019000000BAA035B5FB3C4DC0E3CCA6E7D34C41C00C3345B91E3D4DC01E7FBCD5E74C41C09CEC36730D3D4DC089264EB8004D41C02815AC0BFA3C4DC087BD3C571A4D41C05AB74188AC3C4DC05F88D8D47A4D41C081A60F83F23C4DC013E6549DA54D41C051696538F93C4DC0FDE30FC3A94D41C0DAEF3AC4183D4DC0012C5177BA4D41C0752A59941D3D4DC065208606BC4D41C0D9728CC8463D4DC0B8D20A6FC94D41C0DF1C56504E3D4DC04E674229CB4D41C0B4E927AB7D3D4DC0CC3087DED64D41C0A672FA28E13D4DC002CFBA5BEF4D41C01DAB4F2B453E4DC0BFE8B9EF074E41C02C7E45E6753E4DC04D2D6B87134E41C01D490EFD8F3E4DC0619682EFF64D41C03E8C88C7B23E4DC086669D6ECF4D41C0C019216ECF3E4DC0DC76B9D3AF4D41C0AAB04D44F43E4DC0B919B310864D41C0DC6A4EDE0E3F4DC0AD41F727684D41C00C83CE6C273F4DC0A9DB6C804C4D41C0D488C24B3F3F4DC034FF66E62C4D41C055D85F1E633F4DC0D12AC0AAFC4C41C0326B82D1EA3D4DC0458316A2E34C41C0BAA035B5FB3C4DC0E3CCA6E7D34C41C0","VILLA DEL PARQUE",4988.99500475,1318915.85896,17647,8356,9291,11,4
118,"0106000020E61000000100000001030000000100000013000000A05E075D4A3D4DC05FEBBA22C24C41C0441FD1C9FA3C4DC037D8CD61D34C41C0BAA035B5FB3C4DC0E3CCA6E7D34C41C0326B82D1EA3D4DC0458316A2E34C41C055D85F1E633F4DC0D12AC0AAFC4C41C0FB6FF955643F4DC0740716BFFC4C41C0CAD8820399404DC02CE4E01D124D41C0BB79FFAFC0404DC0C49F3610154D41C009C6877277404DC008CD199FE74C41C0CCD83F561D404DC052FDB093AF4C41C063F2317CA33F4DC0C4140793644C41C0AEC9ADB3A13F4DC05A09CB79634C41C029A82445553F4DC0D1CA2CDE684C41C00240889ABE3E4DC0769A6FD3724C41C0E7608C79883E4DC069561962764C41C0DC60DF01D63D4DC0B4E9FDA7834C41C070F9D822D43D4DC08FF613C7834C41C00E8ABB2BD03D4DC0FB045056884C41C0A05E075D4A3D4DC05FEBBA22C24C41C0","VILLA DEL PARQUE",5685.55336752,849980.083473,13207,6059,7148,11,4
119,"0106000020E610000001000000010300000001000000170000002C7E45E6753E4DC04D2D6B87134E41C06579073D8C3E4DC0A3F467D8184E41C05D0E9D77A03E4DC04A0C579F274E41C0895C33B3023F4DC00284B667724E41C0E369F1481C3F4DC05DBF9A8D874E41C0397ED643553F4DC0C402C9E4B84E41C089A05BC46E3F4DC0826F2D7DA44E41C08B9F4F81EA3F4DC0A2B21116174E41C06368806106404DC05C83C8A5F74D41C023AA5A1B76404DC0EF323769784D41C05E4BA63ECA404DC0817A1CFE1A4D41C0BB79FFAFC0404DC0C49F3610154D41C0CAD8820399404DC02CE4E01D124D41C0FB6FF955643F4DC0740716BFFC4C41C055D85F1E633F4DC0D12AC0AAFC4C41C0D488C24B3F3F4DC034FF66E62C4D41C00C83CE6C273F4DC0A9DB6C804C4D41C0DC6A4EDE0E3F4DC0AD41F727684D41C0AAB04D44F43E4DC0B919B310864D41C0C019216ECF3E4DC0DC76B9D3AF4D41C03E8C88C7B23E4DC086669D6ECF4D41C01D490EFD8F3E4DC0619682EFF64D41C02C7E45E6753E4DC04D2D6B87134E41C0","VILLA DEL PARQUE",4765.8472507,1229983.34811,17728,8164,9564,11,4
113,"0106000020E6100000010000000103000000010000001B00000038D6BEAA2E3D4DC0DF8D596DAD4F41C001C71FDF5B3D4DC065855A71C44F41C0CB2B20A0A93D4DC09FD9D3FAE54F41C0FF7DC3C6CA3D4DC00DBD37ECF34F41C01DFC44F0813E4DC08224D45C614F41C08A54BA7FEB3E4DC02D843E2A0D4F41C0C530D59E0E3F4DC0FC19FC18F14E41C0F8AB9EA5313F4DC0AF966627D54E41C0397ED643553F4DC0C402C9E4B84E41C0E369F1481C3F4DC05DBF9A8D874E41C0895C33B3023F4DC00284B667724E41C05D0E9D77A03E4DC04A0C579F274E41C06579073D8C3E4DC0A3F467D8184E41C02C7E45E6753E4DC04D2D6B87134E41C05D9D0AB4743E4DC038050FD8144E41C04932E0266B3E4DC0E14F8AB1204E41C016B2618E5F3E4DC05BE4980F314E41C0772855AF563E4DC0EA8AA5373B4E41C063C30C804E3E4DC0C8C46960454E41C086107342353E4DC00A65998A654E41C0D3E0EBB3FF3D4DC078E21D91A74E41C02B9974DACB3D4DC079AD8EB7EA4E41C0C8AFEDECB13D4DC057BD5FC1094F41C09A5964AE983D4DC0B9C44DEB294F41C0B9F3F4CC633D4DC0C66BC8606B4F41C00E8E19575E3D4DC022E6B346734F41C038D6BEAA2E3D4DC0DF8D596DAD4F41C0","VILLA SANTA RITA",4542.72580394,1070609.72259,12152,5845,6307,11,7
114,"0106000020E61000000100000001030000000100000017000000B4E927AB7D3D4DC0CC3087DED64D41C0C6B483D6653D4DC0F81AB695F54D41C091F2DD85FC3C4DC08C339626794E41C0A178035DAE3C4DC043304604DC4E41C0AD621B2A5E3C4DC0673BE567404F41C0B9096DCB283D4DC0D55D1D70AA4F41C038D6BEAA2E3D4DC0DF8D596DAD4F41C00E8E19575E3D4DC022E6B346734F41C0B9F3F4CC633D4DC0C66BC8606B4F41C09A5964AE983D4DC0B9C44DEB294F41C0C8AFEDECB13D4DC057BD5FC1094F41C02B9974DACB3D4DC079AD8EB7EA4E41C0D3E0EBB3FF3D4DC078E21D91A74E41C086107342353E4DC00A65998A654E41C063C30C804E3E4DC0C8C46960454E41C0772855AF563E4DC0EA8AA5373B4E41C016B2618E5F3E4DC05BE4980F314E41C04932E0266B3E4DC0E14F8AB1204E41C05D9D0AB4743E4DC038050FD8144E41C02C7E45E6753E4DC04D2D6B87134E41C01DAB4F2B453E4DC0BFE8B9EF074E41C0A672FA28E13D4DC002CFBA5BEF4D41C0B4E927AB7D3D4DC0CC3087DED64D41C0","VILLA SANTA RITA",4542.76742263,1083337.84002,14866,6945,7921,11,7
115,"0106000020E61000000100000001030000000100000019000000AD621B2A5E3C4DC0673BE567404F41C0A178035DAE3C4DC043304604DC4E41C091F2DD85FC3C4DC08C339626794E41C0C6B483D6653D4DC0F81AB695F54D41C0B4E927AB7D3D4DC0CC3087DED64D41C0DF1C56504E3D4DC04E674229CB4D41C0D9728CC8463D4DC0B8D20A6FC94D41C0752A59941D3D4DC065208606BC4D41C0DAEF3AC4183D4DC0012C5177BA4D41C051696538F93C4DC0FDE30FC3A94D41C081A60F83F23C4DC013E6549DA54D41C05AB74188AC3C4DC05F88D8D47A4D41C0BBB21945AC3C4DC0168301AC7A4D41C0ECB1C3CC793C4DC0531E0D1EBD4D41C021BB61EA4E3C4DC0E919920BF64D41C04A5397631E3C4DC07BDE6170364E41C09CD06EB0063C4DC0CB14333C554E41C0DD629692E23B4DC01DB3C2D4844E41C0827AEDE0A73B4DC074A1E049D24E41C0110AA41E9B3B4DC0DF311A64E24E41C0EA25D3C4E63B4DC04A597BD6024F41C03F677864FC3B4DC0C44A87280C4F41C0AC8E882D0B3C4DC027AF2A1A144F41C05486E7370C3C4DC092965CA8144F41C0AD621B2A5E3C4DC0673BE567404F41C0","VILLA GRAL. MITRE",4206.81336686,915447.123736,12357,5962,6395,11,26
116,"0106000020E61000000100000001030000000100000018000000BBB21945AC3C4DC0168301AC7A4D41C08D21DF11613C4DC044D1A6194C4D41C046691994373C4DC0E390A9522D4D41C0EA662B79363C4DC08981A39B2C4D41C0808D2DBA2F3C4DC0A2D50907294D41C01A9032A41C3C4DC0F91C92E41B4D41C0808CE839053C4DC0775A19DC094D41C02155A67CD13B4DC0145FBB8B164D41C01231771B703B4DC05EBC98F12E4D41C0A52C1243BE3A4DC0696495155C4D41C03BCA183FAF3A4DC093A76200604D41C0F83FF5C8393B4DC0E83945D7BE4D41C0E9BEC9E8D23A4DC09206021A8E4E41C00F041C41CF3A4DC05F1C9BBB934E41C07923CC0DCF3A4DC0EF47040B944E41C0F1237BEF733B4DC02949A194D14E41C0110AA41E9B3B4DC0DF311A64E24E41C0827AEDE0A73B4DC074A1E049D24E41C0DD629692E23B4DC01DB3C2D4844E41C09CD06EB0063C4DC0CB14333C554E41C04A5397631E3C4DC07BDE6170364E41C021BB61EA4E3C4DC0E919920BF64D41C0ECB1C3CC793C4DC0531E0D1EBD4D41C0BBB21945AC3C4DC0168301AC7A4D41C0","VILLA GRAL. MITRE",4957.77153875,1247255.15392,17082,8159,8923,11,26
120,"0106000020E61000000100000001030000000100000014000000BB79FFAFC0404DC0C49F3610154D41C05E4BA63ECA404DC0817A1CFE1A4D41C023AA5A1B76404DC0EF323769784D41C06368806106404DC05C83C8A5F74D41C041A0212D94404DC0AD0347944C4E41C02502EB1CE7404DC07FC6FFE17C4E41C0F4DEE01C63414DC01965901BC64E41C04CEB843B7E414DC07CC89E5FAD4E41C02796C03790414DC082DEAAAC994E41C090F00EA6BC414DC084733D54674E41C00CB30EFBD4414DC0A2C3D67F4D4E41C07FE519A0F7414DC06774C389264E41C0356F8ECE31424DC08CC9192FE64D41C0DBE5DF656A424DC036103824A74D41C0A38DE95EBC424DC0A541B6834C4D41C0B172A2C9D6424DC077C5BC012F4D41C08CE10979EA414DC0464A7195254D41C0F5F91687AD414DC02D45FABD234D41C0B5E79F893B414DC06CD953301E4D41C0BB79FFAFC0404DC0C49F3610154D41C0","VILLA DEVOTO",5385.86518722,1619167.20896,18572,8786,9786,11,38
121,"0106000020E61000000100000001030000000100000019000000F4DEE01C63414DC01965901BC64E41C0BE63C194AB414DC037B1AFE6F04E41C0AF53D6A0AB414DC0FADB44F1F04E41C042115B602B424DC05AFF3540634F41C0E61451DDB0424DC029929D34FD4E41C0E7AEBF62F5424DC056EBB8EFC84E41C022D137521B434DC0358B7452AB4E41C04C20D22F35434DC0839B9762964E41C02DE7580237434DC06C28DD8D974E41C02322C5824A434DC096DC73218A4E41C0B1EA1A0884434DC046BD3001604E41C060BBFED884434DC0390746655F4E41C08A42EE54A7434DC0CB1FF0A3454E41C0563A09A4C5434DC08B3624D4314E41C0105E6B244E434DC0FAFF7EC2334D41C0B172A2C9D6424DC077C5BC012F4D41C0A38DE95EBC424DC0A541B6834C4D41C0DBE5DF656A424DC036103824A74D41C0356F8ECE31424DC08CC9192FE64D41C07FE519A0F7414DC06774C389264E41C00CB30EFBD4414DC0A2C3D67F4D4E41C090F00EA6BC414DC084733D54674E41C02796C03790414DC082DEAAAC994E41C04CEB843B7E414DC07CC89E5FAD4E41C0F4DEE01C63414DC01965901BC64E41C0","VILLA DEVOTO",5311.99203511,1619905.87426,15046,7406,7640,11,38
122,"0106000020E61000000100000001030000000100000012000000129FC0EA6F404DC0E2F0684A184C41C07B8825885E404DC0D98F943F1F4C41C03AB7A1A259404DC05C08B115214C41C018CC68FAF33F4DC0E3A24679464C41C063F2317CA33F4DC0C4140793644C41C0CCD83F561D404DC052FDB093AF4C41C009C6877277404DC008CD199FE74C41C0BB79FFAFC0404DC0C49F3610154D41C0B5E79F893B414DC06CD953301E4D41C0F5F91687AD414DC02D45FABD234D41C08CE10979EA414DC0464A7195254D41C0B172A2C9D6424DC077C5BC012F4D41C0105E6B244E434DC0FAFF7EC2334D41C042F07259F3424DC0496C83B0724C41C0D4EE9659D1424DC0D8129FC9734C41C0F4A368429B424DC04346E8CB6C4C41C00200E887EA404DC003E1FC342B4C41C0129FC0EA6F404DC0E2F0684A184C41C0","VILLA DEVOTO",5988.15314803,1583897.11618,13900,6521,7379,11,38
123,"0106000020E610000001000000010300000001000000160000000CE0B1C4E6414DC034DF83A66B4A41C0CA36D039E0414DC0BEB08A2F724A41C09F380CE1DD414DC0DC529687744A41C0AED250E3DD414DC0A7C25D8B744A41C049FA079E40414DC0E8E00CFA214B41C0F905813740414DC0904C096A224B41C0B96A886C9C404DC0D3C60AAFD74B41C09F9680BB71404DC08757F1B8064C41C0AAAC581E65404DC0D70228BB144C41C0D0C404F473404DC0578C52AC164C41C0129FC0EA6F404DC0E2F0684A184C41C00200E887EA404DC003E1FC342B4C41C0F4A368429B424DC04346E8CB6C4C41C0D4EE9659D1424DC0D8129FC9734C41C042F07259F3424DC0496C83B0724C41C0C4646D1801424DC0E05E6D636F4A41C02974897AFE414DC09B0668E6694A41C0434F9017FD414DC0D0B04DFE664A41C0FAA2BE52F5414DC0997E94A8674A41C02996A98FEA414DC0B06B3D94684A41C0B90B3357E8414DC0A353B8146A4A41C00CE0B1C4E6414DC034DF83A66B4A41C0","VILLA DEVOTO",5652.46014945,1580839.74076,13508,6436,7072,11,38
131,"0106000020E61000000100000001030000000100000027000000D739E9F81D3E4DC0C8FADB44AC4741C0021E98CE3C3E4DC068D60E54BB4741C0B32681B7D83E4DC0E504E11C044841C0EFE5C962F73E4DC0A93EE7F8D84741C0C2CC4C5B903F4DC0432595C1214841C087CA090B913F4DC07ACC7B15224841C0AFD1945E53404DC0763CB2A8804841C0614ED93920414DC0561867FEE44841C00A2E3FBF27414DC0708854ABF54841C0F116D8412F414DC00B784C65F24841C0E77C0FFA35414DC00A59157DED4841C0E270EE163D414DC0F6A0BBA2E54841C0E1E1E69E42414DC0A3747670DE4841C0CEBF209C17404DC01F25EF7A614641C0680B205612404DC018129DE36A4641C0B660879BFD3F4DC05EED008B7C4641C0440C555AF23F4DC0D21B9177804641C0D4D2C5BFD43F4DC0A25E403DA54641C0C5F2FC3AA13F4DC06F81CE04E34641C0FC729607833F4DC02E0560CA074741C093217D1B7D3F4DC0502ED81A114741C0C06D7C2F773F4DC08A6ED50B144741C02C98ABED6B3F4DC0478C9C0C144741C04B17C6AB603F4DC0B4794712134741C05032D698563F4DC054A9ED9F104741C0EB7A76274A3F4DC069FBF3B90B4741C029BAAF44413F4DC0129B19380C4741C05871D8283A3F4DC060D1B3A60F4741C01B71D51F2D3F4DC0397EC89D114741C0A0F47405063F4DC04B5B7E2C0F4741C08D6868D8D43E4DC0F62D70BC0C4741C04DC56F09B63E4DC04C7C92450B4741C085EDFEA28E3E4DC0EC518A51094741C0C8D2E458863E4DC0C9DD6506184741C0EF2366B9783E4DC0115EC4B1284741C0C01DD996643E4DC0A761BDA3444741C091F1970D413E4DC0D35C5F1D784741C05D8B9741223E4DC0E1C288B5A54741C0D739E9F81D3E4DC0C8FADB44AC4741C0","SAAVEDRA",7109.0389968,1977721.93131,5485,2666,2819,12,21
132,"0106000020E61000000100000001030000000100000028000000B7FD7E0C0E3D4DC09CE6440B194741C00FBF0121673D4DC059BC7A7A4B4741C047EB68BCA23D4DC011D116546B4741C0214962C4E43D4DC0E1FDBF3E914741C0F9B25754FF3D4DC0DE73CC4D9D4741C0D739E9F81D3E4DC0C8FADB44AC4741C05D8B9741223E4DC0E1C288B5A54741C091F1970D413E4DC0D35C5F1D784741C0C01DD996643E4DC0A761BDA3444741C0EF2366B9783E4DC0115EC4B1284741C0C8D2E458863E4DC0C9DD6506184741C085EDFEA28E3E4DC0EC518A51094741C04DC56F09B63E4DC04C7C92450B4741C08D6868D8D43E4DC0F62D70BC0C4741C0A0F47405063F4DC04B5B7E2C0F4741C01B71D51F2D3F4DC0397EC89D114741C05871D8283A3F4DC060D1B3A60F4741C029BAAF44413F4DC0129B19380C4741C0EB7A76274A3F4DC069FBF3B90B4741C05032D698563F4DC054A9ED9F104741C04B17C6AB603F4DC0B4794712134741C02C98ABED6B3F4DC0478C9C0C144741C0C06D7C2F773F4DC08A6ED50B144741C093217D1B7D3F4DC0502ED81A114741C0FC729607833F4DC02E0560CA074741C0C5F2FC3AA13F4DC06F81CE04E34641C0D4D2C5BFD43F4DC0A25E403DA54641C0440C555AF23F4DC0D21B9177804641C0B660879BFD3F4DC05EED008B7C4641C0680B205612404DC018129DE36A4641C0CEBF209C17404DC01F25EF7A614641C0E857901012404DC06E60EEA9554641C0C3763070443E4DC0572FE9E9894541C05C0B089C2A3E4DC0B3094708A34541C0026EA61F173E4DC0E8AFECA1BB4541C07C0B0FA3F03D4DC01DF77A0AEE4541C0895ECE9CCB3D4DC0DF6A040C204641C0E56970B7A13D4DC098BE96E4564641C0960FEB63583D4DC0B8DC5846B74641C0B7FD7E0C0E3D4DC09CE6440B194741C0","SAAVEDRA",6085.93580279,2003272.02372,19105,9313,9792,12,21
133,"0106000020E610000001000000010300000001000000120000004D25AAC8ED3B4DC049B739EA434641C05AFD9480BA3C4DC02D4D99B2B54641C0C94C219F9E3C4DC0519D25FCD94641C06A6651EAEF3C4DC043C166FB074741C0B7FD7E0C0E3D4DC09CE6440B194741C0960FEB63583D4DC0B8DC5846B74641C0E56970B7A13D4DC098BE96E4564641C0895ECE9CCB3D4DC0DF6A040C204641C07C0B0FA3F03D4DC01DF77A0AEE4541C0026EA61F173E4DC0E8AFECA1BB4541C05C0B089C2A3E4DC0B3094708A34541C0C3763070443E4DC0572FE9E9894541C09FF8FA07EC3C4DC08AEC1CD9F14441C0CECA7D6F5B3C4DC0FED7B508B44541C0ABAA38A1493C4DC0D29545F2CB4541C0D7BB8033363C4DC066508708E64541C05B72B48FEE3B4DC048E64AE8424641C04D25AAC8ED3B4DC049B739EA434641C0","SAAVEDRA",5263.92871669,1555178.10174,18611,8905,9706,12,21
130,"0106000020E610000001000000010300000001000000210000001B0FBD240E3C4DC01C96B2028B4741C0A2298960C73B4DC0FBEFA7E0D84741C0484A13DFDC3B4DC0FF411A24E54741C032AEE85BB63B4DC0C30F8313F54741C068AEF0DED83B4DC08145C2390F4841C04DCA3238FA3B4DC0D54938DC244841C0BB42BCE8293C4DC0D7A82B3C464841C014497625893C4DC064A12026804841C03905270B8B3C4DC02C8CD04D814841C0CE4EEBBD9C3C4DC0B66DDFC3844841C0A711CD299F3C4DC0B59CD63C854841C0C4A6FBE4BF3C4DC0DF7351B88D4841C069CF1173D03C4DC07E95C1AC794841C0A81099D4F13C4DC0FE5D80238D4841C0EC489DF0F33C4DC064B1CB098F4841C0A68C1C6A143D4DC075B7138A714841C0C937836E593D4DC0A62EA3D9324841C04F103971513D4DC0596091BE2E4841C014518A18603D4DC0223F1CE4294841C01C6FC85A6A3D4DC0F20BCED9254841C081D8ABE97C3D4DC0C05183571B4841C046163F07783D4DC0EF443A1C184841C0C3DFB7A4903D4DC0F5CEF7AB044841C05865E893963D4DC08649E7FCFF4741C0214962C4E43D4DC0E1FDBF3E914741C047EB68BCA23D4DC011D116546B4741C00FBF0121673D4DC059BC7A7A4B4741C0B7FD7E0C0E3D4DC09CE6440B194741C06A6651EAEF3C4DC043C166FB074741C0C94C219F9E3C4DC0519D25FCD94641C0A8B8E02C793C4DC0009666D70A4741C0A0B946EC443C4DC03205C4D84C4741C01B0FBD240E3C4DC01C96B2028B4741C0","COGHLAN",4630.26005463,1280050.87055,15998,7573,8425,12,22
126,"0106000020E6100000010000000103000000010000001A00000040B973A3C03F4DC0769A397DE64941C00D4D600117404DC06998B647A34941C03C01FFC661404DC04B0C2893694941C091104ADA88404DC0DAD93BD6514941C0844A56DFDE404DC0C1D8DDA8214941C0E30BEA01E1404DC00F1B245E204941C00A2E3FBF27414DC0708854ABF54841C0614ED93920414DC0561867FEE44841C0AFD1945E53404DC0763CB2A8804841C087CA090B913F4DC07ACC7B15224841C0C2CC4C5B903F4DC0432595C1214841C0715A580C6F3F4DC0F615524A504841C03D35E2D14C3F4DC0092D7B5D7F4841C092C06B14353F4DC07F84FA879D4841C090241D79193F4DC09A6680B8C04841C0E69EA26AFE3E4DC008773575E34841C047CC2F1FE63E4DC02DF5C15C044941C0FFD8167FDF3E4DC005E1DD960C4941C09DE8F3F8D93E4DC043D13F380B4941C0139272B7CC3E4DC0925E66BB154941C0D16672AFAC3E4DC0223F98DF2E4941C0C92F02EE923E4DC0F0587129434941C0D5E1B432E53E4DC0842DB70A6F4941C0E137DB13243F4DC06E3A92D3904941C011148F255C3F4DC0AD67A4E0B04941C040B973A3C03F4DC0769A397DE64941C0","VILLA URQUIZA",4895.74546912,1391969.70364,16660,8131,8529,12,23
127,"0106000020E61000000100000001030000000100000016000000CE7FAAC54F3D4DC0026D7FE5204A41C0C1A7E28F903E4DC0C8325F71DB4A41C09507A290903E4DC001D79970DB4A41C0515F22BDDA3E4DC0A366E48B9B4A41C0B89294EF0B3F4DC080A989AA714A41C00C7C6BD3233F4DC0FB6FB4585E4A41C0EDD556AD243F4DC0486A6AA85D4A41C0F211F973323F4DC0B0BCFD1D544A41C096275746693F4DC019C0B6772A4A41C0B83F21E5883F4DC02CAF94DD114A41C040B973A3C03F4DC0769A397DE64941C011148F255C3F4DC0AD67A4E0B04941C0E137DB13243F4DC06E3A92D3904941C0D5E1B432E53E4DC0842DB70A6F4941C0C92F02EE923E4DC0F0587129434941C0C8F10C0C793E4DC0401CFB8C574941C0BF504F43413E4DC04FC3CB83824941C0316FDA06443E4DC03370D857844941C0D814A41F203E4DC07D62DBE9984941C058BE3F38FC3D4DC0DD3A9006AD4941C0DE429082733D4DC0EF7255E4084A41C0CE7FAAC54F3D4DC0026D7FE5204A41C0","VILLA URQUIZA",4486.13488424,1190490.00893,20712,9633,11079,12,23
128,"0106000020E61000000100000001030000000100000021000000C2CC4C5B903F4DC0432595C1214841C0EFE5C962F73E4DC0A93EE7F8D84741C0B32681B7D83E4DC0E504E11C044841C0021E98CE3C3E4DC068D60E54BB4741C0D739E9F81D3E4DC0C8FADB44AC4741C0F9B25754FF3D4DC0DE73CC4D9D4741C0214962C4E43D4DC0E1FDBF3E914741C05865E893963D4DC08649E7FCFF4741C0C3DFB7A4903D4DC0F5CEF7AB044841C046163F07783D4DC0EF443A1C184841C081D8ABE97C3D4DC0C05183571B4841C01C6FC85A6A3D4DC0F20BCED9254841C014518A18603D4DC0223F1CE4294841C04F103971513D4DC0596091BE2E4841C0C937836E593D4DC0A62EA3D9324841C0A68C1C6A143D4DC075B7138A714841C07892E1924D3D4DC0E8729ED8934841C0BD050AB5FF3D4DC0D6ACC527004941C093DC2F0B073E4DC031DCA15A054941C0432BB0A9143E4DC0A23D38D1FB4841C0A327B1BD833E4DC0D37754103B4941C0C92F02EE923E4DC0F0587129434941C0D16672AFAC3E4DC0223F98DF2E4941C0139272B7CC3E4DC0925E66BB154941C09DE8F3F8D93E4DC043D13F380B4941C0FFD8167FDF3E4DC005E1DD960C4941C047CC2F1FE63E4DC02DF5C15C044941C0E69EA26AFE3E4DC008773575E34841C090241D79193F4DC09A6680B8C04841C092C06B14353F4DC07F84FA879D4841C03D35E2D14C3F4DC0092D7B5D7F4841C0715A580C6F3F4DC0F615524A504841C0C2CC4C5B903F4DC0432595C1214841C0","VILLA URQUIZA",5021.99123207,1381378.28288,16615,7945,8670,12,23
129,"0106000020E6100000010000000103000000010000001C00000069CF1173D03C4DC07E95C1AC794841C0C4A6FBE4BF3C4DC0DF7351B88D4841C0A711CD299F3C4DC0B59CD63C854841C0CE4EEBBD9C3C4DC0B66DDFC3844841C03905270B8B3C4DC02C8CD04D814841C0CDD68BEF923C4DC0D84AC401864841C01D34D90A973C4DC0C0A7C399884841C0DC596479EA3B4DC0CFC8D010554941C0200C426B823C4DC018F392CBAB4941C0F10D225A133D4DC065C5E0D5FE4941C0A1C93F7D4F3D4DC0543D29BB204A41C0CE7FAAC54F3D4DC0026D7FE5204A41C0DE429082733D4DC0EF7255E4084A41C058BE3F38FC3D4DC0DD3A9006AD4941C0D814A41F203E4DC07D62DBE9984941C0316FDA06443E4DC03370D857844941C0BF504F43413E4DC04FC3CB83824941C0C8F10C0C793E4DC0401CFB8C574941C0C92F02EE923E4DC0F0587129434941C0A327B1BD833E4DC0D37754103B4941C0432BB0A9143E4DC0A23D38D1FB4841C093DC2F0B073E4DC031DCA15A054941C0BD050AB5FF3D4DC0D6ACC527004941C07892E1924D3D4DC0E8729ED8934841C0A68C1C6A143D4DC075B7138A714841C0EC489DF0F33C4DC064B1CB098F4841C0A81099D4F13C4DC0FE5D80238D4841C069CF1173D03C4DC07E95C1AC794841C0","VILLA URQUIZA",5107.04622449,1484636.29981,22633,10653,11980,12,23
124,"0106000020E6100000010000000103000000010000001E00000049FA079E40414DC0E8E00CFA214B41C0AED250E3DD414DC0A7C25D8B744A41C09F380CE1DD414DC0DC529687744A41C0CA36D039E0414DC0BEB08A2F724A41C00CE0B1C4E6414DC034DF83A66B4A41C0B90B3357E8414DC0A353B8146A4A41C02996A98FEA414DC0B06B3D94684A41C0FAA2BE52F5414DC0997E94A8674A41C0434F9017FD414DC0D0B04DFE664A41C03EB46FA452414DC040200258014941C06C7AF65851414DC0A2B87596FE4841C0E1E1E69E42414DC0A3747670DE4841C0E270EE163D414DC0F6A0BBA2E54841C0E77C0FFA35414DC00A59157DED4841C0F116D8412F414DC00B784C65F24841C00A2E3FBF27414DC0708854ABF54841C0E30BEA01E1404DC00F1B245E204941C0844A56DFDE404DC0C1D8DDA8214941C091104ADA88404DC0DAD93BD6514941C03C01FFC661404DC04B0C2893694941C00D4D600117404DC06998B647A34941C040B973A3C03F4DC0769A397DE64941C0B83F21E5883F4DC02CAF94DD114A41C006AF98D6C13F4DC0BBEBF795344A41C0F830180BDC3F4DC0014D91E9454A41C05208D81634404DC01F25C69D7B4A41C06691A29E96404DC095881B1EB94A41C04A86106EE9404DC0630CEC38EC4A41C0A3D5307515414DC0E09B1313074B41C049FA079E40414DC0E8E00CFA214B41C0","VILLA PUEYRREDON",5428.70276858,1737552.54075,16048,7607,8441,12,37
125,"0106000020E610000001000000010300000001000000150000009F9680BB71404DC08757F1B8064C41C0B96A886C9C404DC0D3C60AAFD74B41C0F905813740414DC0904C096A224B41C049FA079E40414DC0E8E00CFA214B41C0A3D5307515414DC0E09B1313074B41C04A86106EE9404DC0630CEC38EC4A41C06691A29E96404DC095881B1EB94A41C05208D81634404DC01F25C69D7B4A41C0F830180BDC3F4DC0014D91E9454A41C006AF98D6C13F4DC0BBEBF795344A41C0B83F21E5883F4DC02CAF94DD114A41C096275746693F4DC019C0B6772A4A41C0F211F973323F4DC0B0BCFD1D544A41C0EDD556AD243F4DC0486A6AA85D4A41C00C7C6BD3233F4DC0FB6FB4585E4A41C0B89294EF0B3F4DC080A989AA714A41C0515F22BDDA3E4DC0A366E48B9B4A41C09507A290903E4DC001D79970DB4A41C03B75A451543F4DC0BDE20A5A564B41C0452867C646404DC0DBC7189CEC4B41C09F9680BB71404DC08757F1B8064C41C0","VILLA PUEYRREDON",5165.18927425,1565359.82794,18747,8955,9792,12,37
145,"0106000020E61000000100000001030000000100000010000000C2C546F54E3B4DC002C5AA3A9A4941C013E976B89F3A4DC04D95D2B0EF4841C0B57EEEC5973A4DC071408B78E74841C0951272A18F3A4DC07D14C182EA4841C007782F5BE4394DC03D47A7AA1F4941C098B7FFD5A4394DC01E90B2EE394941C06BF170767E394DC0D7F76E344A4941C094949D2880394DC0E7A593D14F4941C01B91F59CB9394DC072E211C8BA4941C0D28E6BB0FC394DC04267A807384A41C060F277DF383A4DC0957A4D8A244A41C0D65455AE983A4DC0B69040070A4A41C0D97A31CDE83A4DC0B571B4A7054A41C0266BB6B62E3B4DC0AC225182BB4941C01D7E6B40493B4DC03256CCC49D4941C0C2C546F54E3B4DC002C5AA3A9A4941C0","COLEGIALES",3681.98120907,889148.766997,14765,6869,7896,13,24
146,"0106000020E610000001000000010300000001000000140000006BF170767E394DC0D7F76E344A4941C01A63939C3D394DC011BE2DB4654941C0634DCB7A0F394DC0FAA432B6794941C0E5D36B4CDB384DC0076D86F88E4941C0D6036000C7384DC03B20D47D974941C0259D4109D5384DC055CC6B73A54941C096497659B0384DC0192A92F6BC4941C057BB3EF08E384DC0C45E058DD34941C0B1A31F2370384DC063925A17F54941C02E36590850384DC0288F195C0D4A41C025AF4AA8C2384DC0C43E4FF5774A41C01C6352DCE3384DC0A58D935DA54A41C03494BC7E3A394DC02D84ACDE7F4A41C0E98851EB66394DC07C31EB1A6D4A41C04BA4C26467394DC06CEFCAEC6C4A41C0810F155CB9394DC0496014D44D4A41C0D28E6BB0FC394DC04267A807384A41C01B91F59CB9394DC072E211C8BA4941C094949D2880394DC0E7A593D14F4941C06BF170767E394DC0D7F76E344A4941C0","COLEGIALES",3565.2397492,765595.091363,11466,5421,6045,13,24
147,"0106000020E61000000100000001030000000100000014000000B57EEEC5973A4DC071408B78E74841C0F9CFD92F973A4DC04DDC7CDDE64841C073F5CD7E923A4DC0911C7238D54841C03135CC3A8E3A4DC0E2FDB5B0D74841C00CE9A6ABE5394DC06A41C82B764841C02C529371E5394DC0EA73BF09764841C00A959A307A394DC026F9206FAF4841C00CDBED0B0D394DC0E927B6F8E64841C0531747B8B2384DC02A1F37A8134941C086A5A8DE69384DC0363469D83A4941C065BE5008C6384DC0C4647486964941C0D6036000C7384DC03B20D47D974941C0E5D36B4CDB384DC0076D86F88E4941C0634DCB7A0F394DC0FAA432B6794941C01A63939C3D394DC011BE2DB4654941C06BF170767E394DC0D7F76E344A4941C098B7FFD5A4394DC01E90B2EE394941C007782F5BE4394DC03D47A7AA1F4941C0951272A18F3A4DC07D14C182EA4841C0B57EEEC5973A4DC071408B78E74841C0","COLEGIALES",3751.22827237,633963.634104,20301,8967,11334,13,24
138,"0106000020E6100000010000000103000000010000001F00000010CC0F8E813B4DC075FD0811904841C0DC13615F853B4DC051028E918E4841C0FDA19D78B03B4DC0CB9023EF834841C01901FD40D33B4DC0DA55080E7D4841C03AAE95D6FC3B4DC02B42A4AC784841C09AC40D60203C4DC0129D746B774841C08980E6D63A3C4DC0ECE20A6B774841C0AD7E2609533C4DC07B36EA4A794841C02AD1C2C46F3C4DC0379C5B6B7C4841C014497625893C4DC064A12026804841C0BB42BCE8293C4DC0D7A82B3C464841C04DCA3238FA3B4DC0D54938DC244841C068AEF0DED83B4DC08145C2390F4841C032AEE85BB63B4DC0C30F8313F54741C0484A13DFDC3B4DC0FF411A24E54741C0A2298960C73B4DC0FBEFA7E0D84741C01B0FBD240E3C4DC01C96B2028B4741C02F05EE29353B4DC01AE540551A4741C08090E5EC303B4DC05A3A75D71E4741C061D13C5B1D3B4DC09AFC8D96314741C067AD4FC2083B4DC0F5C72172494741C0475E674FF93A4DC099D282EE574741C062726A0AF03A4DC0F855E8DB634741C009FB7F78DC3A4DC0CDAFEA9A764741C0CFC53BB1C13A4DC01217B3FB964741C08D711178753A4DC07D377F98EF4741C0C6595194743A4DC03EB1B8A2F04741C0CC032617783A4DC09C91DD6DF24741C0F5C32F21973A4DC05E8160F5044841C0929AADB3123B4DC0BE0120194E4841C010CC0F8E813B4DC075FD0811904841C0","BELGRANO",4578.98964049,888040.821871,27460,12258,15202,13,44
139,"0106000020E61000000100000001030000000100000018000000C6595194743A4DC03EB1B8A2F04741C08D711178753A4DC07D377F98EF4741C0CFC53BB1C13A4DC01217B3FB964741C009FB7F78DC3A4DC0CDAFEA9A764741C062726A0AF03A4DC0F855E8DB634741C0475E674FF93A4DC099D282EE574741C067AD4FC2083B4DC0F5C72172494741C061D13C5B1D3B4DC09AFC8D96314741C08090E5EC303B4DC05A3A75D71E4741C02F05EE29353B4DC01AE540551A4741C0B48D6698343B4DC079D29E091A4741C0EAEBBAFEA53A4DC0F7C9E199CF4641C0153FADC4A53A4DC08DD39D7BCF4641C0FAE6A0F38F3A4DC05A4F06F3E04641C030A9F310653A4DC05608C5E8FE4641C0AC7A9C29263A4DC0D255D5F6234741C0BFC51B1EEA394DC0C809F712454741C07EFB7042AA394DC013519C8C684741C049E4A8EC9C394DC07A7F8D1C704741C0351A5FFCAB394DC049E5F2CB7A4741C011F0110FDF394DC064A1B65A994741C0E28177E21F3A4DC0C6CB4B0AC04741C0CFD1C87A623A4DC07C920A60E74741C0C6595194743A4DC03EB1B8A2F04741C0","BELGRANO",3046.01347048,525616.437172,18063,8121,9942,13,44
140,"0106000020E6100000010000000103000000010000001C00000021BBE1B69D384DC03E0BB07AEB4741C0967F1B48A1384DC09C6B7A9CEA4741C04E4B1E44CA384DC01DF97D00DE4741C0AD551E71EF384DC058D122D1CF4741C004755D8516394DC0B52FFFAFBD4741C0E5B9F6652D394DC0B81A2D49B04741C0396D148A67394DC0B291C1638E4741C049E4A8EC9C394DC07A7F8D1C704741C07EFB7042AA394DC013519C8C684741C0BFC51B1EEA394DC0C809F712454741C0AC7A9C29263A4DC0D255D5F6234741C030A9F310653A4DC05608C5E8FE4641C0FAE6A0F38F3A4DC05A4F06F3E04641C0153FADC4A53A4DC08DD39D7BCF4641C07709E608273A4DC0DCB632528D4641C04871FDDBFC394DC06EC3B4F0764641C0EC3E6C58FF394DC00A1662DD734641C0F0E7FB1EE5394DC018989258914641C0AD1BC099AB394DC0F373C6B2D44641C09F81F78382394DC0E84ECFA8034741C0B90A76DC69394DC012DAF951214741C08AD009C243394DC0320DDCCE4D4741C039C1CDE222394DC0CFD12D80734741C02B0FD005FF384DC07992BC479C4741C0596569E2E1384DC070CEE9E1BE4741C01EE812F4CF384DC0A1EB9D45D34741C038A5A584BF384DC0CBF0698ADC4741C021BBE1B69D384DC03E0BB07AEB4741C0","BELGRANO",3951.05203501,466228.792446,8070,3908,4162,13,44
141,"0106000020E6100000010000000103000000010000001B030000FC9413C706384DC01C2F5E49004841C077CDC7911E384DC0E7DBBE32FF4741C00E8A86D328384DC01DCF701EFE4741C066EA87D643384DC0DA582748FB4741C07A40199646384DC02012C8EFFA4741C0C290980163384DC010062C5DF74741C07E614E0278384DC0B7D26701F44741C071AE338378384DC0C4130BA4F44741C0F56E23E080384DC0D33DCA7DF24741C021BBE1B69D384DC03E0BB07AEB4741C038A5A584BF384DC0CBF0698ADC4741C01EE812F4CF384DC0A1EB9D45D34741C0596569E2E1384DC070CEE9E1BE4741C02B0FD005FF384DC07992BC479C4741C039C1CDE222394DC0CFD12D80734741C08AD009C243394DC0320DDCCE4D4741C0B90A76DC69394DC012DAF951214741C09F81F78382394DC0E84ECFA8034741C0AD1BC099AB394DC0F373C6B2D44641C0F0E7FB1EE5394DC018989258914641C0EC3E6C58FF394DC00A1662DD734641C09969FF2E093A4DC065BB9FB3674641C05F67205A223A4DC00C2B3E2D524641C041552EA5203A4DC0D0BF12C4444641C09D5527A2113A4DC09DF1317A2F4641C08F4BAAB3DF394DC077DC67CFEE4541C0CA142458C1394DC02FAEECA0C64541C0976A2406B7394DC03ED7EFA2B94541C05C0A6C3394394DC0FD14A8FF8C4541C0B0C4A14881394DC0DB4AA9BF744541C0A13E1FC8A0394DC05B8F880D644541C02F413564D2394DC077CE3A59494541C019489AA2D6394DC0534548B3474541C0D22FBDCCE8394DC0B0153EA6404541C038201A73F6394DC04F6EA5103C4541C0203D08FEF9394DC0FF00CBEF3A4541C07207498A013A4DC0A0510389384541C0B5071AF0163A4DC06E4D5D5A324541C0E8BCD5681C3A4DC0FAD2CFC5304541C02EFCC32E2A3A4DC0128EE7382D4541C0CF2E2900363A4DC043BA83A8284541C0BF077EA6433A4DC0F27CCCF3214541C0B6F2402A4F3A4DC07A7B8F4E1C4541C0C850FCCC5F3A4DC0B989128B144541C05340F4056D3A4DC070ED138B0E4541C0D39878AB7A3A4DC07C584B7C074541C0BD7C994A8E3A4DC04C6F41F5FD4441C00927F679903A4DC0E03DADFBFC4441C0F1269303AA3A4DC016E8638CF04441C056C2D6E9BE3A4DC02E15E813E24441C0125D9702C13A4DC048EEAE93E04441C0A6295918CF3A4DC08D8ED982D64441C01177E949B53A4DC0169433C1C14441C0E3405756AF3A4DC04DC9F142C54441C041F99CD3663A4DC09BD1EA84A64441C00F77BADA553A4DC06B15CF989C4441C0456267963C3A4DC0545FF288904441C07B37961A213A4DC040ABC01D814441C0AA1A309E183A4DC0630FE7617C4441C03C673F31143A4DC09C89DF8C7A4441C0E49C9F55123A4DC095A8F636794441C02FD9BFDF103A4DC0A6704D56784441C0799F9725103A4DC0F3C9AF21774441C08032B901113A4DC07ECDA86A764441C090669147103A4DC023FBAC27754441C0FC4D0103103A4DC09C2FAA38744441C08927D001113A4DC05762722E734441C019A3DF9A113A4DC04B89CC69724441C07CA5E69A113A4DC0FD826A6C714441C0550D968B103A4DC0D981C5646F4441C0D2BEB76F103A4DC0F713ABF36D4441C09150BA18113A4DC04CCB10CB684441C0075E82DA113A4DC0B946F186664441C0745F3692113A4DC00AFF927E644441C01D1ECB3F103A4DC0680D8216634441C0753562FB0D3A4DC0E15BDCC2614441C0CEEDA97C0A3A4DC0964768BA5F4441C0BEDF9048073A4DC02BFBB7285E4441C0D5E356F6033A4DC07035911A5B4441C0E3AB3517003A4DC090EECAD4564441C082842CBCE5394DC0525EB6ED344441C031872D81DE394DC052196F6D2A4441C0088757D9DB394DC047A60B60274441C0B17293FBD6394DC0C9F5978E1F4441C036BE43BCD3394DC05743A1E41B4441C0A07CB642D2394DC0B25348F6184441C009FF77BCD3394DC0A2A7F8C9154441C08216DEEAD4394DC0CEA952C2114441C0E087AD4BD3394DC068C6D47B0D4441C055661D7ED0394DC06CC099040C4441C0D483DFA3D0394DC04E986B4F0A4441C0DD56E74FCF394DC034BA634F0A4441C03B274CD6CD394DC0EFE03A16094441C0C7EBAD79CB394DC08833E7480B4441C048A7FED4C9394DC06F46975C0D4441C09B1C6539C8394DC0A7DBD04A0E4441C0C6DF9C4EBD394DC099F213A61B4441C0910236EDB5394DC073EC91A3264441C09A7B53AEB2394DC00B2691022C4441C0A093FFF0B1394DC035A8A86D2F4441C032004334B1394DC0197EFB3E374441C0F35B0651B0394DC08EFF7DE4404441C027CA42F4AD394DC010DF4463464441C0C2B36DCEAD394DC0FC8666ED494441C060A3E9C0AB394DC0ED8F952C4D4441C02666B62EA9394DC0797137A2504441C097F78D04A7394DC03114BD73534441C09F0A9ECDA4394DC01AAB6668554441C0B7C2E0C4A3394DC0089E0C70594441C0F681C2F6A0394DC0FC07D103664441C0CD8C36CC9B394DC0F8286D4B6F4441C022B1EC619A394DC0163E67057B4441C0197BDAE099394DC084F71B897F4441C0390521F19B394DC0DCCA0E33834441C0F43148739E394DC0D40F6D02864441C0866CF851A3394DC0B7AD77CB894441C04CA78538A9394DC02BA6EDB98C4441C0E3506A6FAB394DC0B0F82E3D8C4441C036761F31B1394DC0C79F26D98C4441C048DF5620B8394DC07ED572128E4441C00D332BABBB394DC08ABB1DCE8E4441C09F801953BE394DC0013FF62B8F4441C022085DD5C0394DC0ACC8052C8F4441C0FE4ECEE5C2394DC0A17D122C8F4441C063734FD1C4394DC05C4F8FAE8E4441C08359C0E1C6394DC0F7659B8F8E4441C07395E746CA394DC0B2ECAF8F8E4441C03EA151ABCD394DC0C6C6FC508E4441C0D8C813C5D0394DC0FD12662C8F4441C01DF74E0CD5394DC07DFB439D914441C02CC7A9C6D8394DC0F7D8A40D914441C0D95F838ADB394DC0AB0FCEA3904441C0C400D625E1394DC05F5459E88F4441C0FC11259CE6394DC0BAACD501914441C0C245CFD6ED394DC0B6CB6C65904441C09AB83F6AF2394DC049D753E2904441C070E9D1DFF7394DC033C0C7BD914441C0C7E3D3F8FA394DC0DCADA41B924441C09C94D63FFE394DC0B76C0140924441C0C676A1D7FF394DC0688E8BB7924441C08FD9AB9C013A4DC080902335934441C0EA082488033A4DC01952906D944441C0B07A13A1063A4DC034F3EE5B974441C067D1A9B60D3A4DC02F4591FF9B4441C09FDABFE0123A4DC08E91E6A3A04441C0B2BDB6D5133A4DC04161342AA24441C024B94B99203A4DC0097C309CAC4441C01E3CD1A1213A4DC0DCECC16AAF4441C025B5B2C72A3A4DC0778B5EA7BA4441C0F31FCFD82C3A4DC0585CF475BD4441C04361303D303A4DC0468084C8BF4441C0B131C7FE353A4DC076F1D47FC64441C0123D6278373A4DC08FC92B8DC94441C09A71A3C3373A4DC08C7102EDCE4441C0AC4E4395363A4DC0A39051FAD14441C074EB9F8C353A4DC0C1AC0C4CD44441C0B5C562AA343A4DC00D55571BD74441C037037ACD333A4DC04A7C15DBD84441C0F0ED4956333A4DC0DC39C680DB4441C06C0E7E2C373A4DC076042550DE4441C098E49B0E383A4DC0CD2C8CA7DF4441C053DA75453A3A4DC00B2A865DE14441C00A252AC3373A4DC00560DD95E24441C0BDD12052373A4DC03549B21EE14441C00E3CD923363A4DC031844BE6DF4441C07D956B90313A4DC05E997DB3DD4441C0C8F9A816303A4DC067D523BBE14441C0680F47942D3A4DC0366E3407E54441C0CFF1C1832B3A4DC00DE44653E84441C0D90011D3273A4DC0DE7872F7EC4441C061A13E05253A4DC090DD4095F24441C0477A1011223A4DC0C608C063F54441C06DFAB78E1F3A4DC043C36E96F74441C01AFDD9DE1B3A4DC022424A2DF94441C0E07747F7153A4DC0F2337D1BFC4441C0ADCD2063FF394DC05E648576074541C04226EECAF5394DC0E9F6CCFA0B4541C00F51268CF2394DC0C94250B60C4541C034BDE97AF0394DC07ABFD9710D4541C0D0991D59EC394DC091C376B7114541C007F34DD6E0394DC0FDA0D87E104541C078F98821D8394DC09ED19867044541C01E3642B9D8394DC00983FE8AFE4441C0ABF131D6CE394DC0020E124FF34441C04AD51BE7C7394DC00439E858EC4441C02CEDE064C5394DC0445B2045EA4441C029322B26C2394DC01EAC3DA9E94441C0B1624F7AC3394DC00D0D01E6E44441C0896000ACC0394DC04274DDD7E14441C03A5D9DACBD394DC0FDA794EFE04441C00F6A80B2BA394DC0F2405645E04441C0E1251E64B5394DC011C1C0E7DE4441C01D024547AF394DC04640701CDB4441C0B727635DA8394DC06657CF2FD74441C0CF4FCAE2A0394DC0FF8E3798D24441C0C4336EF297394DC0DB3D1465CA4441C0FD7EF29595394DC07FC08212C84441C0D167CEBB95394DC00F9C0BADC34441C05BB05F9695394DC003339934BD4441C09B8B8F9695394DC06BE65771B84441C09B25718297394DC023C9158DAE4441C04A1C3EA897394DC01CD9C79EAB4441C09CF0FA2A9A394DC0B7EB9804A04441C0D426620D89394DC0BEA93607954441C0C26F61827C394DC0263CDD108E4441C0ABE8DB257A394DC0D2BCA6B88C4441C0FB0CFD9A76394DC0C19E54168D4441C0C6E31F9375394DC051D6E6F08D4441C0A65513EB72394DC0E0C287E58F4441C0EF00069771394DC096F075F8914441C0E8E6AC5272394DC0E2448CED924441C06255FE0772394DC0D9C5FF69944441C090439B2D72394DC0E90CEE1F964441C08D6E75B482394DC024982BA69F4441C00087973685394DC06DAB55F2A24441C0B9AB8AA785394DC06981ACE0A54441C09AAE217984394DC0567ABA0DA94441C06DB43BAE74394DC09DF81EB6BC4441C0C70081FD70394DC064B3B3BDC04441C0FCCD89626F394DC043ABE3A2C34441C0A3CBDEAD6F394DC05ADCCCFBC44441C071EC68BA71394DC009477CF2C74441C017D8BFCA73394DC000D717A2CA4441C0D64F659075394DC0DD2AD18ACE4441C0777CF0CE78394DC058739BD0D24441C058B9819C7B394DC0A5173023D54441C0C9B429B67E394DC0575E2BCDD84441C0B6BE64E47F394DC037599724DA4441C0A0A15F907E394DC0C65522E0DA4441C0FBE926DA7B394DC0DE07EB11D94441C0A7F9C8227A394DC06308833CD64441C05837C5F874394DC0C41A8BDCD04441C097486C5973394DC0FA6FEA20D04441C00D84146E71394DC0A297F876CC4441C039000E386F394DC0DA0D61E6C94441C04E2299876B394DC06B3E8575C74441C05C99C36567394DC018A4DFF9CB4441C0B50493C958394DC0F329CB08D44441C059BCFDF22D394DC0D8FC6878EB4441C02CF414C128394DC09ED68A0CEE4441C04783D5C71F394DC056BFC20CF34441C01E5F4FE30C394DC07BB11099FD4441C049A4C67601394DC083A3EDDF034541C074A303F0EF384DC0DB5D95A40D4541C07F835EE9BB384DC076B573062A4541C0F0F72254B9384DC0EB92638D2B4541C096E5019FBA384DC0BFA825ED2C4541C0BE128F29B4384DC084F26F6F304541C050956FDFB2384DC003C2AD0F2F4541C0F0ABF4B4AD384DC0EF302144324541C03ECE2484A7384DC01CBD7E3A354541C062BF0101A3384DC0C50A135F384541C03B73121A9D384DC0337E401E3B4541C06E9930938B384DC0E21C3746444541C05203CC0397384DC012D1D0623B4541C053FECB78A0384DC0C12DF464364541C08AE6BFB6A6384DC0491744672E4541C0051D29EDA8384DC01A48A43D2A4541C01A871ABDAA384DC019CE5814254541C00250ED2AAF384DC015ED68E9244541C081D41ED0B6384DC0E0D19B6A224541C0D8CB413FBC384DC097211D411E4541C039F76777BF384DC0FC0EA56C1B4541C05C5DF34AC3384DC0BEADE598164541C0C693124EC5384DC0B7039F99124541C08A23424EC5384DC02DA18E6F0F4541C07B1DC7B5C5384DC05A9AF5700B4541C068FDF1B8C7384DC01699259D064541C0275BFD86C8384DC00299D39D024541C047AE30F4CC384DC08EDEBFF3FF4441C0A785AEFAD0384DC07DF4DA9E004541C020352BCCD3384DC08C0E509FFF4441C030FC86FFD3384DC01D06BCF4FD4441C0946D40CFD5384DC090E0DB1FFC4441C09A235AD2D7384DC05641B04BF84441C079D7C6A5DB384DC068B73C77F54441C0ABF5D6DDDE384DC06E87C6CCF34441C03813197DE2384DC07B1F174DF34441C0AAC2796CE4384DC03F271FC6F14441C0B9C16C1FE8384DC0DFFE83CEEF4441C07ECB738DF1384DC01E5D3F62EC4441C052801EEAF3384DC07C0D38D2EA4441C06881011CF9384DC00E49E02DE94441C0BE444BA4FD384DC081F6FF11E74441C025446B4A03394DC0330D33A8E24441C0CB57FE1C07394DC0F453C0FDE04441C08A3C33550A394DC09A8A4F54DC4441C0118BF29110394DC0D8483D55DA4441C05F8B02C912394DC0CE94E400D74441C09DE6849D17394DC0357BB401D34441C0B1CB29DA1D394DC0FFBB6257D34441C03E9CE3B426394DC08CF22BD7D44441C05697448A2C394DC0E06EE681D44441C0D0C81C5733394DC02DA96A3CD04441C09B5CC59835394DC0D98B0BDACB4441C06DF8ACD239394DC0D9EF7ADAC84441C012D5FF3C3C394DC01B316C31C54441C02A3643DE40394DC077BAE95CC04441C0215D4F4B45394DC06DE939DDBF4441C0EE76CEBF4E394DC0AE0979B2C14441C0B3E83F3256394DC090FB2F08C24441C0AFFD186B5A394DC0FDC21687C54441C0BE07FCA15C394DC09E2CFB06C64441C0BB2BD26E5C394DC0282E34B2C34441C041A18B9D59394DC0AC55B15DC04441C0D0F1EB9856394DC0FFAD22DEBE4441C000DABFB851394DC0B7E06FC9BA4441C04BE3DE5D52394DC0B8527CFCB94441C00A49EB5D52394DC09C8131ECB84441C02DE8911451394DC0F0A1B453B74441C02608F0F34F394DC0F87D6054B54441C09E9EF59C4B394DC0821E6D78B14441C0ED9F97C946394DC0B4D0BEBDAD4441C0CA981E4942394DC0A0DCD4F2AA4441C0DBA89AA53C394DC021368862A94441C07C4C929D37394DC0F7A12AB9A34441C03C8BE96333394DC0D0FD710EA24441C09023F1F52D394DC05C419CE49F4441C0E189255328394DC0F60D1D0F9F4441C0F089B78024394DC063CDCE649E4441C08D1877AC1F394DC08A4EB3B99D4441C083C322A319394DC006D2500F9D4441C06B1743FF12394DC0DE3BF7E39C4441C06A2AE0290D394DC01A640DB99D4441C0E62874EC06394DC0AE9599E39E4441C0DC52481500394DC0F4392D639F4441C0958081A3F8384DC0FAA5BB0CA14441C0B216F54CEF384DC07D72DCD1A34441C0DF21936BE7384DC006B924F2A54441C078A55914E3384DC05A711847A74441C0AC9BD125E1384DC065C21FADA74441C0B9F306ADDD384DC09769080AA84441C0C1E8D842DB384DC0B70FDEB4A84441C09195BFA1D6384DC0E8FA1009AA4441C0D8E89CFFD0384DC0DEB73C09AB4441C01E83E78ECA384DC0E61E0033AC4441C074615318C0384DC0CC360187AF4441C0445751DDBA384DC0B9FE5106B34441C04BD0BC9FB4384DC058185F2FB64441C0C63D1401B1384DC0BC486784B94441C0D8D69B2CAC384DC0D277CD58BC4441C0C2C97EBDA6384DC0DDE0FFD6C04441C0054D5642A3384DC0870956B0C24441C001CB3719A0384DC07EFD61D5C64441C0FB9981469C384DC028E91C7FCA4441C0E89F38A597384DC0BB80CD28CE4441C0D94C5E9D92384DC0A00F7EFCD24441C0D89D033390384DC093D0FCD0D54441C0437FF0F88B384DC00CD472A5DA4441C054E5E8BE87384DC01B3239CEDE4441C07215D4BB85384DC02EDE32F8E14441C0BAC2B08282384DC0C6678B76E84441C01ED92C177F384DC0585AF01FED4441C0AF28704079384DC0C83E4D1DF64441C0842A24D173384DC0BADC879BFC4441C0C387B89870384DC0DB36B799034541C0050246FB6E384DC02E52ABC0134541C06E93CDF96D384DC0F6CDA5E9194541C09716752A6D384DC0B5497891254541C0DD148C256A384DC0B05EEE65284541C0482EDB1F66384DC06FC4A010274541C0C7D122E762384DC0EF0B1DE6264541C0567E7E145F384DC08CB8E1BA284541C0CA3EC7145F384DC0DA132A91244541C026C6647A5E384DC022805D3C224541C0A53A3BE05D384DC0A81723931C4541C0B2F3AA0F5B384DC075A8F5921A4541C0ADFA4B435B384DC070A83B3F154541C01811E4624F384DC05199FF3B214541C0BF3BA28041384DC0B19C78B9284541C0F6574FAC3C384DC0F482C563284541C05688446C34384DC00BECA539244541C0C45ED39A2E384DC0D4C8787E214541C0A451AE9E29384DC00D64EA7E1F4541C0A77F354F21384DC0EDEB5139204541C066F9B1DE1A384DC009EBDFB91D4541C06CD6636B12384DC0DF278C0F1A4541C0ED27A42D0B384DC00EB5CFE4194541C074480BF004384DC09BB7CAE31B4541C026BC1948FB374DC003E1A00D1C4541C01EA618FEF5374DC04A3731061D4541C0FC55104BF2374DC096BE5F491F4541C081CF6E9BEF374DC0A2F7328C204541C0B716D8C6EA374DC0618600B6234541C01B422CBCE3374DC02FBF45DF254541C09B371F4DDE374DC05FDA09DF274541C0FF99F36ED7374DC093F7CDCB294541C0C9AEA751D1374DC026601BFD2C4541C0C6AB4397CC374DC02596245B324541C0033E385BC7374DC05FCEDB59374541C06DAFC622C4374DC023DD82D83C4541C09097A21DC1374DC066619BD6414541C05E58A07CBC374DC0A6BC4CD4494541C0DCA14277B9374DC0BEB5627D514541C0954AEA71B6374DC0B1EC56FB584541C023027E6FB5374DC01C2A99F95F4541C0C402DC04B3374DC0EB97304D654541C0C49479CDB0374DC00791E6CB6A4541C06F3D9E34AF374DC06E7D43CC6D4541C06B92F7AFAF374DC0AF08A452714541C03ACC1390AA374DC0DE44FFAB724541C007617730A6374DC078A4DBA6734541C06B219F16A1374DC0832DE7DB744541C0415A86599C374DC0FFF7A4E9754541C0E31CCFCA96374DC09E1B106B774541C08899796A90374DC0AE90553A794541C0079CBE208A374DC0B859831C7B4541C0A46D92BC85374DC07929C6827C4541C0BAF3D2FD84374DC0059262D17C4541C0101414E383374DC09443CF297D4541C0C6AAB0DF82374DC02C820E897D4541C0E28CA2E781374DC0563490EA7D4541C0455590EF80374DC0171BD0497E4541C0190FFEF57F374DC04CC34BA87E4541C0430D70FC7E374DC04C39C6067F4541C0D2039D037E374DC05D0806667F4541C0DFE08E0B7D374DC080E0C5C67F4541C097EAFA147C374DC0EEA9CE29804541C0BCE1AB1D7B374DC014AAD28C804541C0A3F65C267A374DC0C8D357EE804541C0FA9E4E2E79374DC01BFA9950814541C0403BC03778374DC06C7A64B4814541C00919F14177374DC0EC0EEC18824541C010A3A44D76374DC02B2D7D80824541C047C3985B75374DC093F811EB824541C09195546D74374DC030FE335A834541C07F2DD58273374DC0CC78A1CE834541C0E5365B9E72374DC067B09E4A844541C0308269BE71374DC0EAF56ACD844541C01EA877E170374DC05C18FF53854541C0E8090A0670374DC02BDC16DC854541C0FEE69A2A6F374DC0FD62F064864541C0A3EAA84D6E374DC03A4246EC864541C0D508B76D6D374DC0820FD36F874541C021C93C896C374DC09ABC53ED874541C0805EFCA06B374DC07A9BC364884541C01E38FBB46A374DC005DC30D9884541C0145C77C769374DC07D16984A894541C057B632D968374DC0CC12FEBB894541C08DD0AEEB67374DC08FBA612D8A4541C0DD5EA9FF66374DC037260DA18A4541C0EA58AC1666374DC0866F80188B4541C0F300323265374DC0C43A3F958B4541C0D07E7C5164374DC002B687168C4541C0FF264B7263374DC0900D129A8C4541C05742989462374DC0FDB4E71F8D4541C0A19969B861374DC0AB723DA78D4541C0E0E3BADD60374DC0D6D116308E4541C0EB57900460374DC08A6A34BB8E4541C0CE0B252C5F374DC07BD213478F4541C066C439555E374DC0DD15B5D38F4541C01873137F5D374DC073FA1661904541C07B61ACA95C374DC0DADC3BEF904541C0DA7D04D55B374DC06026E37E914541C0E29EDC015B374DC0824B4C0F924541C037EC7D2F5A374DC060923CA1924541C07388995E59374DC0B3FAE933934541C0E75F398F58374DC0C3331CC8934541C0BA31D9BF57374DC0913B4D5C944541C0C69E39F156374DC043D901F2944541C0265D592356374DC0CF0BBA87954541C0CF4C7D5555374DC02D482F1E964541C09AFB618854374DC095BCA5B4964541C016EE40BB53374DC056B91F4B974541C02EE164F052374DC078D919E3974541C017900B2752374DC05305577D984541C0E5A1785E51374DC05FBB5A18994541C08B4F9F9650374DC043EF5AB3994541C068F7C5CE4F374DC093205B4E9A4541C0F0412D064F374DC004435BE99A4541C07B893DA54D374DC06BCF0F179C4541C0846EB4E54C374DC0CB9AA4B99C4541C026C067254C374DC016D7725B9D4541C0C35515654B374DC09C1041FD9D4541C0519BC8A44A374DC00002149F9E4541C0E1203BE549374DC09E09A4419F4541C04C2E712649374DC0186DF9E49F4541C01353276948374DC0995B4B88A04541C0BA575DAD47374DC09C3EE62DA14541C0596FD8F346374DC0B07F3FD4A14541C0BA99953C46374DC07B93E07CA24541C0F1C4978745374DC03A9D0027A34541C0523259D644374DC03C872BD4A34541C0DC40232844374DC088A2D682A44541C0C5CF307C43374DC00391C933A54541C0FBF5BCD142374DC0158B7FE5A54541C0541D8E2942374DC0044DB398A64541C084F11F8241374DC0BC99AD4CA74541C049AA6FDB40374DC0FAF0A700A84541C03773013440374DC0083AA2B4A84541C069C9918C3F374DC03FC79768A94541C09DE662E43E374DC0AA730E1BAA4541C0D640F0393E374DC0FE6C81CDAA4541C05C49798C3D374DC0D26AB27DAB4541C01F9941DE3C374DC064C2222DAC4541C0110807303C374DC0C61793DCAC4541C050A053833B374DC01091C08CAD4541C08CE860DA3A374DC07CEBF83FAE4541C00310B9363A374DC0E8C075F5AE4541C0A5EBD49939374DC09959B8AEAF4541C070B4FD0239374DC02892C66BB04541C020D3E56F38374DC0462C192BB14541C0097E94E037374DC0CC90EFEBB14541C0B217885337374DC0B36C0BAFB24541C06A1D80C936374DC0BF11E872B34541C0DD50374036374DC0804E4838B44541C0D59C6EB835374DC03EA3A8FDB44541C07684693135374DC0A40309C3B54541C06AC6A0A934374DC0EF556988B64541C0AB695C2334374DC094C0C94DB74541C06BA15B9F33374DC02D51AA14B84541C01071D91C33374DC0E8D653DCB84541C08FC39D9C32374DC0C602B7A4B94541C071E81F1D32374DC02017E36DBA4541C05122E79F31374DC0878BCD37BB4541C0CCE9AC2231374DC03F2DB901BC4541C0351A74A530374DC0859FA3CBBC4541C09E583B2830374DC08E4ACC94BD4541C0987F02AB2F374DC0B6BAB65EBE4541C09DEBC32D2F374DC07129A128BF4541C0CE0450B12E374DC0BA6A4DF3BF4541C049BB95352E374DC045B7F9BDC04541C0887BA0BA2D374DC0D70FA688C14541C026EA6B402D374DC05A3A1454C24541C0E95C75C82C374DC0F189821FC34541C0EBC643512C374DC0597DB1EBC34541C09E3792DB2B374DC0F77DA3B8C44541C0EA9828682B374DC0263C5686C54541C07DB83AF62A374DC0DAD8CA54C64541C039E211852A374DC0C7813F23C74541C08DDFA6142A374DC0A4FC75F2C74541C0355402A529374DC0C23DB1C1C84541C02667173629374DC077D0E790C94541C0C724B2C828374DC032DAA061CA4541C07CD7CF5C28374DC05F2B5B32CB4541C064A46DF227374DC055951503CC4541C06120CC8827374DC013A390D4CC4541C0EE446E2127374DC0EA9CCDA6CD4541C0004C93BB26374DC07DA4CD79CE4541C06133F95726374DC0D22ED04CCF4541C07A6BE3F525374DC0220D9120D04541C0B8504C9525374DC05A0452F4D04541C09D887B3525374DC08B9496C9D14541C0330028D724374DC0933DDB9ED24541C0E8FF557A24374DC0338B2374D34541C01BDFCB1F24374DC0BDD1EA4AD44541C065D9C1C623374DC06631B221D54541C06634F76F23374DC0ADAB3CF9D54541C02239701B23374DC0F0E387D1D64541C0B561B1CA22374DC0F8E7D6A9D74541C07B46337C22374DC01C13A683D84541C00B41B83022374DC00143745DD94541C043F445E821374DC0A1260938DA4541C0228152A421374DC0CC915C13DB4541C08CCDE46121374DC074AE70EFDB4541C047B2BD2121374DC0C4AB89CBDC4541C07A1ED3E320374DC075DB5FA8DD4541C04C7E30A820374DC035F8F785DE4541C02540CD6E20374DC0ED8C5564DF4541C050D5EF3620374DC01CB0AF42E04541C0AB72500120374DC01DCB0821E14541C0876235CD1F374DC09CF42400E24541C0105C9A9A1F374DC0498906E0E24541C0E2CE83691F374DC0C2B721BFE34541C056EDB03A1F374DC0A001009FE44541C0EBCF9E0C1F374DC0AEE3E17EE54541C0BCCECAE01E374DC0096CFD5DE64541C0E521BDB51E374DC0D547A13EE74541C031DAF18C1E374DC040CA7E1EE84541C0916367661E374DC0F3671FFFE84541C0D04DE4421E374DC09B96C2DFE94541C0F1B0E2201E374DC0CF1924C1EA4541C0201D1F011E374DC06B7D8AA2EB4541C0ACF0DFE21D374DC01F41EC83EC4541C0C0DEE5C61D374DC0FEF10F66ED4541C05D7D6AAC1D374DC0F1473748EE4541C0888373931D374DC07F2C5B2AEF4541C0955E027C1D374DC0302B7F0CF04541C036340A661D374DC098CEA6EEF04541C02786D8501D374DC0D5F3CAD0F14541C0A3D1293D1D374DC0F3ECF3B2F24541C0923CFB2A1D374DC0F1451895F34541C095C64C1A1D374DC0B6B83C77F44541C050DE610A1D374DC02B8A265AF54541C08FCABAFC1C374DC002314B3CF64541C0ADC710EF1C374DC02B29351FF74541C01FCFAEE31C374DC02BBD1B02F84541C0BAE607D91C374DC0372F01E5F84541C0399F24CF1C374DC0C396ECC7F94541C084E5C2C61C374DC0D22FD2AAFA4541C03526E4BF1C374DC0CA9CBC8DFB4541C0CD2DC6B91C374DC03D8BA370FC4541C081A167B41C374DC059C0C852FD4541C0716A8DB01C374DC02861B335FE4541C07C9C37AE1C374DC0A4909A18FF4541C042CA2CB71C374DC067D75402004641C0EB53F4CF1C374DC08ECA5DF4004641C0331BC9F11C374DC0869532EA014641C0706DA2161D374DC0619407E0024641C07DBDB6371D374DC0EFADD1D2034641C04DAB3F511D374DC01536D1BE044641C0C92BBA5B1D374DC0ED1D759F054641C0B13ED4511D374DC0094EB871064641C04864962D1D374DC06A171231074641C09960D3D91C374DC02D1431D5074641C0C93E619019374DC0F6061779084641C03C1C891D0A374DC07B6EC83FFE4541C09FD321F40B374DC057F3CAAFFC4541C0B45603C308374DC042710B65FB4541C0E6FDEE0708374DC00F2FBE51FC4541C0F8B86B4E07374DC06441D7F8FC4541C04A6C269A06374DC0F251FBA2FD4541C0D98AE9E805374DC0588CE250FE4541C0463DBB4305374DC0521C9E05FF4541C0B740A1AD04374DC0BDA16DC3FF4541C06DF1122204374DC047B44987004641C0306C489A03374DC02ECEE74B014641C042BF451603374DC05E428D13024641C054BD129F02374DC03F48FBDE024641C0800B383902374DC0811A38B1034641C0C9E267DF01374DC0A037FF87044641C084CE5F8901374DC0B88B895F054641C03345D02E01374DC0799A5036064641C0E0F741D100374DC056675A0C074641C0D96FBE7F00374DC07BA1A5E4074641C05BEB554300374DC099C77BC1084641C04E7F4A1B00374DC03558E0A2094641C035639B0A00374DC04EC104850A4641C0615D981900374DC0611530670B4641C054236B3500374DC0D79257490C4641C0862BFC5400374DC0558CBD2A0D4641C06028167900374DC06A61270C0E4641C03670639600374DC087328DED0E4641C05CAD25A900374DC02DD575D00F4641C0D93EC4CE00374DC0E0665DB0104641C03AE5531C01374DC0EE667589114641C0F558BB7901374DC02A66875F124641C0B4F9D3CB01374DC05F6FA438134641C033A6332302374DC0B8033610144641C083FAF99702374DC0747678DC144641C0E706EE2D03374DC02A20599A154641C0936CAAC703374DC0460ABA56164641C0CB75BC4404374DC0A35CB520174641C0711DEEA804374DC0D63587F4174641C02E89B41D05374DC08946C7C0184641C0826AB5BC05374DC006D86079194641C04CC4D87006374DC0DF4ADE251A4641C0F978BF2B07374DC029BB52CC1A4641C0A27473ED07374DC025077A6D1B4641C0353730B808374DC00F9A4F061C4641C0839AB68609374DC0BD262A9F1C4641C0E47EC85C0A374DC03B54AF2F1D4641C0C6342A410B374DC0969C02A81D4641C00072F33C0C374DC00F2301F91D4641C0C868D94A0D374DC05B03412D1E4641C0EABEB9580E374DC0DFA3C2601E4641C003157C210F374DC0112849461C4641C0C088E1810C374DC0E4C102D51A4641C0F3AFFEF019374DC05C66ECFF0E4641C0FF4EC9211E374DC097498B810F4641C0F9B8C9611E374DC084C10B50104641C0F5A8DB7F1E374DC04D960B3C114641C03260148B1E374DC083162A37124641C0BEB683921E374DC0F4A50030134641C02DBC00A31E374DC0143EBA19144641C0375487B61E374DC0311EE1FB144641C0391905C71E374DC069550BDE154641C0168A82D41E374DC0A093F3C0164641C07FA5BDDF1E374DC0E4AADBA3174641C0D98FB3E81E374DC06926C786184641C0091125F01E374DC055FCAE69194641C0D0CAD5F61E374DC0A8509A4C1A4641C088D107FC1E374DC0BDFF812F1B4641C07AD839011F374DC0C7AE69121C4641C0BFB92C071F374DC0F52F93F41C4641C022C15E0C1F374DC0D8DE7AD71D4641C04B03F3E81A374DC09706E2331F4641C03906070D17374DC0606DF9CD214641C0E0AFE22314374DC008432268244641C078B08A5911374DC0B6CA6AFD274641C0FC779AE80D374DC02AD5D36C2B4641C081204AFF0A374DC0C26857B22F4641C08789B52508374DC0DBB9E2CD344641C0423D1EC304374DC0F35AABF1374641C0543C203301374DC0B69E9F8F3C4641C00AD92494FD364DC0F3C29E63404641C0C4C675F2F8364DC07B038D26454641C04A5629BBF4364DC00D705120494641C045707259F1364DC01C3C3FF14A4641C02F9B8EBCEE364DC05630B72B4C4641C07BB00A3CEB364DC0965DFAC14C4641C048A5A846E9364DC0958E85F44C4641C0609DD7B9E6364DC0BB646AD34B4641C029F211D1E3364DC06B4683B14A4641C0812A4853E1364DC0466ED21A4A4641C0FDD94905E0364DC09DAAD4264A4641C04BB9A9B4DD364DC023307D4C4A4641C07A7FB647DC364DC09DC5DFA44A4641C032CF2843DA364DC02954B4AC4B4641C0FEEE5A5FD9364DC0AA589CB44C4641C0052618D4D7364DC0C7A0CE784E4641C03E846B0ED7364DC039005CCC4F4641C0DCD2DA9ED4364DC0227AB162504641C05CAD297CD2364DC05EECEC05514641C015400EE2CC364DC09E5C27D14A4641C018682D98C7364DC060CF7BF0484641C0B6DB7E88C3364DC000ACACB3484641C0ED9E7294BD364DC0B2F5CEBF4B4641C0636FEFD6BA364DC027E441F44E4641C070024601B8364DC0B823F127524641C0FFD4427EB6364DC0756C4A58544641C0A99EAB1CB6364DC0AE611364574641C0AB25BBBBB5364DC0DBCF64605B4641C0C4AF0473B5364DC059C304955E4641C08B707593B1364DC06FEF81845F4641C04C0D4D97AF364DC04F2CC6985F4641C05C65CB61AC364DC0CA3C62A05C4641C0E87D3778A7364DC0204504A05C4641C01EBB28ADA5364DC0D32A5EAF5B4641C0FE145CC9A3364DC02D38827F594641C0D2D726F4A0364DC05D2633A3584641C009D429A69D364DC04A36751A594641C07F4B5DF29B364DC061AC6742594641C0515637279A364DC0A989311A594641C0FDDC8BB297364DC0403BD115584641C05B92764293364DC014CFA0FD564641C0137A53938F364DC0254A6871564641C00E76861E8D364DC0BC05CD5C564641C08F43A7B789364DC0392A5111574641C08C76FAD785364DC03C7AF704594641C06A694BEA82364DC02978E0485B4641C059C68B7F81364DC0F2F8DC245C4641C0949B036781364DC01C095ABD5F4641C080D113BD80364DC071349B51624641C022FF3A527F364DC0CAE6B409644641C03634E2397F364DC0D295A5FD654641C02BAEB4867D364DC06603763D674641C0703E6F7C7C364DC0411CAA69684641C039CCAE4D9B364DC05F5A144AA04641C054F16608A0364DC00418CB94A84641C03B093C43C8364DC06A1FFC9F974641C0A2851573DC364DC0171F5B1E8F4641C076D22D74EF364DC02AEA62E7824641C0E83C62D400374DC02FCF52C1844641C02CE835430A374DC0B39860FD854641C0757A086B17374DC029C1AE39874641C0672FAFAB24374DC02968655A894641C0E68D04CF26374DC0BA0746B2894641C032F821C42C374DC0185534578B4641C0832627B733374DC0E7B3B0D58E4641C076212DCC4A374DC0FDBCB4029D4641C05AE49E067C374DC048346D5CB84641C035D10D487E374DC039A7DFAAB94641C0A7FE5FBE8D374DC0C2345013C34641C07597458E9A374DC007379BDECA4641C042C6552BA2374DC041CAF268D34641C00E26FCA0A2374DC072EDE5D9DB4641C0225897BC91374DC0EB97AC77E74641C095E43C5999374DC0E2E2E258EC4641C06752F43CB4374DC0FE2E5240F84641C0B8FF9939C1374DC00A33F200FE4641C06DD6B319CA374DC05D4CA56F034741C01415FF8CD6374DC086BA7F0D0B4741C00E758D88E3374DC0F331016A154741C07FC004DEE4374DC05FC6A79B164741C0EFA32042F4374DC06DA0555A244741C07F94C725F5374DC0ADD0D625254741C06EF8A21704384DC02A63D8A72E4741C07B167C592D384DC021A522D53D4741C0898FE60447384DC0D0B45C2E464741C047BE4AC65F384DC0F1CD0C15534741C06D8EAADB74384DC0CB7D7F53684741C07039031B7D384DC0E6C6FD527E4741C0C27A752B80384DC002093825864741C02355C1597A384DC0A2A14BE0984741C0BD90DFD669384DC04DDCFB74B64741C0C2E0893E4F384DC09D765E74CC4741C04EC8A4C83F384DC0FFF71F2AD54741C095552B5B25384DC042E2345FE04741C0B494AABC13384DC0D35D1588E64741C0AD212BDE10384DC08B6F4025E74741C054761CBBFE374DC010DC2303EB4741C0922EE39FF8374DC050362081EB4741C060EA5BF3E2374DC090AABA3FED4741C06C1A4F35DE374DC05412783FED4741C066347045CD374DC01E3A873EED4741C03ECAA165C0374DC0B080B7FFEA4741C0269EA46DAD374DC0FF388EC0E84741C0950E9900A8374DC0940B7F47F24741C0C99BD54ABA374DC05E21646B014841C045E12D33C9374DC05B003D6C014841C0AB15B9D8DC374DC099EEFD8B024841C0997FA355E6374DC0CD0F9600024841C06BA65CFBF9374DC0E79434DF004841C0FC9413C706384DC01C2F5E49004841C0","BELGRANO",15975.9117526,4071107.64611,14230,6883,7347,13,44
142,"0106000020E6100000010000000103000000010000001D00000071AE338378384DC0C4130BA4F44741C089AEBD2B82384DC0376CDCE5004841C0BE4DEA95A3384DC0422F8038254841C0A66477F4A4384DC0B113A500274841C0AD883019A8384DC08FE5AEFA244841C04ED10DA754394DC02D0FBDB98A4841C00A959A307A394DC026F9206FAF4841C02C529371E5394DC0EA73BF09764841C00CE9A6ABE5394DC06A41C82B764841C02A34060A003A4DC07BAF3FBB674841C0E7F57B660C3A4DC0060D515C5E4841C062062308223A4DC0B8F7B294514841C069400DAA373A4DC024320905384841C0BFF41E72523A4DC0DACC4F7E184841C0C6595194743A4DC03EB1B8A2F04741C0CFD1C87A623A4DC07C920A60E74741C0E28177E21F3A4DC0C6CB4B0AC04741C011F0110FDF394DC064A1B65A994741C0351A5FFCAB394DC049E5F2CB7A4741C049E4A8EC9C394DC07A7F8D1C704741C0396D148A67394DC0B291C1638E4741C0E5B9F6652D394DC0B81A2D49B04741C004755D8516394DC0B52FFFAFBD4741C0AD551E71EF384DC058D122D1CF4741C04E4B1E44CA384DC01DF97D00DE4741C0967F1B48A1384DC09C6B7A9CEA4741C021BBE1B69D384DC03E0BB07AEB4741C0F56E23E080384DC0D33DCA7DF24741C071AE338378384DC0C4130BA4F44741C0","BELGRANO",3633.96477299,786067.482474,24502,11002,13500,13,44
143,"0106000020E610000001000000010300000001000000150000000CE9A6ABE5394DC06A41C82B764841C03135CC3A8E3A4DC0E2FDB5B0D74841C073F5CD7E923A4DC0911C7238D54841C0F9CFD92F973A4DC04DDC7CDDE64841C0B57EEEC5973A4DC071408B78E74841C0CEAA3512A73A4DC03725E4C1E14841C0B9CD7C83DD3A4DC00AACF6BDCD4841C071FA85260D3B4DC08A0AE29ABB4841C0AB3FC2A92D3B4DC0D2F218B8AF4841C03ED7D2465A3B4DC0A21910759F4841C010CC0F8E813B4DC075FD0811904841C0929AADB3123B4DC0BE0120194E4841C0F5C32F21973A4DC05E8160F5044841C0CC032617783A4DC09C91DD6DF24741C0C6595194743A4DC03EB1B8A2F04741C0BFF41E72523A4DC0DACC4F7E184841C069400DAA373A4DC024320905384841C062062308223A4DC0B8F7B294514841C0E7F57B660C3A4DC0060D515C5E4841C02A34060A003A4DC07BAF3FBB674841C00CE9A6ABE5394DC06A41C82B764841C0","BELGRANO",2911.02493846,456500.932121,17625,7629,9996,13,44
144,"0106000020E61000000100000001030000000100000018000000B57EEEC5973A4DC071408B78E74841C013E976B89F3A4DC04D95D2B0EF4841C0C2C546F54E3B4DC002C5AA3A9A4941C082353310D23B4DC0CDFD04EC474941C0DC596479EA3B4DC0CFC8D010554941C01D34D90A973C4DC0C0A7C399884841C0CDD68BEF923C4DC0D84AC401864841C03905270B8B3C4DC02C8CD04D814841C014497625893C4DC064A12026804841C02AD1C2C46F3C4DC0379C5B6B7C4841C0AD7E2609533C4DC07B36EA4A794841C08980E6D63A3C4DC0ECE20A6B774841C09AC40D60203C4DC0129D746B774841C03AAE95D6FC3B4DC02B42A4AC784841C01901FD40D33B4DC0DA55080E7D4841C0FDA19D78B03B4DC0CB9023EF834841C0DC13615F853B4DC051028E918E4841C010CC0F8E813B4DC075FD0811904841C03ED7D2465A3B4DC0A21910759F4841C0AB3FC2A92D3B4DC0D2F218B8AF4841C071FA85260D3B4DC08A0AE29ABB4841C0B9CD7C83DD3A4DC00AACF6BDCD4841C0CEAA3512A73A4DC03725E4C1E14841C0B57EEEC5973A4DC071408B78E74841C0","BELGRANO",3697.26994965,736411.415674,8353,3776,4577,13,44
134,"0106000020E610000001000000010300000001000000A0000000B52187A9453A4DC0F2C3FB6A554441C052499043423A4DC00DDDFA3A584441C0A75B7347403A4DC0B18C41CF5A4441C051AC8AAC3E3A4DC0DDFD8E175E4441C034AE53A23D3A4DC03E84E4C7624441C0116780D23D3A4DC0709B5FAC654441C0976FCF4B3E3A4DC03DB95954684441C0D482BA0C3F3A4DC0F574BE5C6A4441C04BD19FBF403A4DC0BE2714F16C4441C0E4913069413A4DC062E5210D6F4441C04DF782BF403A4DC0C08982C9714441C0A2B960E63F3A4DC0AA24B581734441C0B17D1DC43E3A4DC039EFA675754441C0EBB45C413D3A4DC09B30EA55774441C05C7379673C3A4DC0DE07D995784441C0AB16D7FC3A3A4DC00BCE878A7A4441C09493EA533A3A4DC0EE08D9D27D4441C06DD92FFB3A3A4DC0FD975D44804441C06F7B4BB43A3A4DC05A87D8E2814441C0652637673C3A4DC01F406C87834441C097DEFEF33E3A4DC0DBDA3877844441C05D465A2E403A4DC0D7E23D77844441C04B81A2AB773A4DC03B7C0E07A14441C01745295F7B3A4DC096AD5DE4A24441C08A8219A1B93A4DC040CD7D8EBF4441C01177E949B53A4DC0169433C1C14441C0A6295918CF3A4DC08D8ED982D64441C04EFEFA9B483B4DC0A21D2DDE514541C07A7104464F3B4DC045C2BE244D4541C0E332509D5D3B4DC0F9578325354541C050F714127A3B4DC0A59052B9434541C07417441A7C3B4DC0E3E842BE444541C095941F1BA43B4DC05F023DCC584541C068B624F5B73B4DC06AE785BF624541C08E027C64F53B4DC09C5BBDC4814541C0E76EA0F40C3C4DC006AA0FE68D4541C0EC24D760323C4DC05034C229A14541C0CECA7D6F5B3C4DC0FED7B508B44541C09FF8FA07EC3C4DC08AEC1CD9F14441C0721A14A6E93C4DC0DB1EEACBF04441C07A47366AA23B4DC05C4E6344604441C03CE617AB843B4DC087130321534441C08B0FCFA75D3B4DC084CA84E4414441C08E890866063B4DC0711C0DABDD4341C0AEE7BCBCFE3A4DC0E3ACCEDDD44341C083BAE5D4BE3A4DC0756C87758B4341C0825F5B02BD3A4DC04B69D60D894341C019C50F09BA3A4DC01F29902A894341C08C87FEA6B63A4DC06EBE0CF1884341C0C117BE7DB43A4DC05B9178B9894341C031F20EA6B03A4DC01CD8040A8B4341C03A1C0245AE3A4DC0FA69F2688C4341C0FADEB8B3AB3A4DC0FC3C61158D4341C00B16B689A93A4DC01B459CF88C4341C0A6C47590A63A4DC0E35AB5678B4341C01F26D751A33A4DC0CF080DD6894341C0F5A0D827A13A4DC05F71609B884341C0755E26739E3A4DC019997199874341C082CC94AA9A3A4DC009C8A67C874341C0001BDD8D973A4DC0C8FE6526874341C0766542B7943A4DC0987E9E09874341C0BD53994E8F3A4DC022364999874341C0ED4CF9158C3A4DC01579BC67884341C0B98641258A3A4DC0640BBD2F884341C0E6038BA6863A4DC01BE58793884341C058E54045833A4DC0E3E5AF9D874341C000F0D867803A4DC08212E0B8874341C0EFBBE7F07A3A4DC0AC259EEF864341C04DF06BD3773A4DC0416A4F77864341C0595ADFAB733A4DC0D1CE1BDB864341C0261E1F316E3A4DC0BA43662F884341C09017C9396A3A4DC0A9393347894341C0221D4D1C673A4DC071DE2DFB894341C068622C47643A4DC0555A93C38A4341C03E97B9F4623A4DC0B9A2A89F8B4341C05ECD483D613A4DC0720D8E0C8C4341C075C5FD835E3A4DC08212D9738F4341C0113065585C3A4DC02A8578A8924341C023445C665B3A4DC014BD7204964341C0A8B13E5C5A3A4DC0684A9248984341C01FF2D0135A3A4DC04C069D189B4341C0D06D3E745A3A4DC090A487119E4341C0F439D8F65B3A4DC0C3C85FD1A14341C09DAF5FA05C3A4DC014C03956A54341C01922297A5D3A4DC0A1014872A74341C00F6EEA655B3A4DC0C842956EAB4341C0914FA139593A4DC0CFFF525EAC4341C091746B56573A4DC0B7D1963EAE4341C0ABFC0F1E553A4DC09A2E4309AF4341C0C59D75B5523A4DC059A8905AB04341C07202F5974F3A4DC018410C4BB14341C099A3D3D04B3A4DC09810DC16B34341C030A9F5E1453A4DC0ECD4CF32B54341C0B1523F4B403A4DC07A5973DBB74341C0C8D5D5453D3A4DC0438646A7B94341C0A030E1613B3A4DC06ABDAF23BB4341C0C353A97E393A4DC0BD03B33FBD4341C0AD8F1930363A4DC093D24F74C04341C00EB1F0A7313A4DC0011A13E8C44341C0177328682D3A4DC0122200BDC84341C0D6EC6CB42B3A4DC055BFB0ECCA4341C0BFC4F5A0293A4DC0FEB1DDA4CC4341C0A41D01BD273A4DC0AAF3C2E4CD4341C0584DD5E7243A4DC0B25856B1CF4341C0952B4ACA213A4DC058B8277DD14341C08B98ED011F3A4DC07F71E03CD34341C02B7CDCA11D3A4DC023D8EA01D54341C05D9217111D3A4DC0A8598909D74341C0F08B181F1C3A4DC07CD708FAD74341C0360676A61B3A4DC09A73B975D94341C04C863E92193A4DC07141F955DB4341C083224DAA193A4DC0E32E88AEDD4341C0E3096C1D173A4DC0CA1D01FBE14341C09F098282153A4DC04D9822A7E54341C0E8173960143A4DC01CDE5313E84341C08FA83E9F133A4DC0A0F1FEDAE84341C03C4FAE5A113A4DC094B09103EE4341C0DB3D905E0F3A4DC012BABE6FF04341C07DA522550E3A4DC09CF18FF4F34341C0157C206D0E3A4DC038A47B90F84341C083977CCD0E3A4DC0B35D4755FD4341C09C3C289D0E3A4DC011446A4D004441C09937B7540E3A4DC0ACE722F6024441C06F6F84FD0E3A4DC03F403112054441C0A4E2D541113A4DC0A5437832084441C0782891CE133A4DC023B48F4E0A4441C03E8F465B163A4DC073C0EAE20C4441C0622D562C1B3A4DC0F00134F7114441C0CB69F46F1D3A4DC006447563144441C056EA9B231F3A4DC0B7C2DAB7154441C0845EF328223A4DC07F353298174441C000486985243A4DC08A3435401A4441C06880AC80263A4DC0506F8C201C4441C0C395D094283A4DC02129C7D81D4441C095EDA42B2C3A4DC024A9E1401F4441C08A6238FC2E3A4DC025B9F797214441C05FA667D8323A4DC04DAB5397234441C0A581A32D363A4DC02C10C5F9254441C05AE9E51D393A4DC05F883851274441C0806DEA163B3A4DC01EF21366284441C0A81A525B3D3A4DC02A88D1A6294441C098F31A8C3F3A4DC07042202D2B4441C0797C2BF6413A4DC06FFA834E2D4441C0F0911EAF433A4DC0AD09AFA62E4441C098CA412D453A4DC0BA6300D62F4441C094802676473A4DC0C6C63D3F324441C080C53F4B4A3A4DC070D2D397344441C0901B95E54C3A4DC092D950F5354441C0B5750F60513A4DC05B1374E4384441C08CF2B713533A4DC0BF72AF9C3A4441C06A0B064E543A4DC097EBA2DC3B4441C0FB9D78E3553A4DC025131B7A404441C088B26DB8553A4DC0C5821611444441C008C76BC6543A4DC0DBA17419464441C0C624B143533A4DC0DA556159474441C041986F2F513A4DC04CF9D43D4A4441C0DC3F12034F3A4DC0C924EB814C4441C046D3185E4C3A4DC06BFB5F664F4441C06921FEA0493A4DC0D804795E524441C0B52187A9453A4DC0F2C3FB6A554441C0","NUÑEZ",6144.47722195,1595513.61399,8389,4120,4269,13,47
135,"0106000020E61000000100000001030000000100000035000000A6295918CF3A4DC08D8ED982D64441C0125D9702C13A4DC048EEAE93E04441C056C2D6E9BE3A4DC02E15E813E24441C0F1269303AA3A4DC016E8638CF04441C00927F679903A4DC0E03DADFBFC4441C0BD7C994A8E3A4DC04C6F41F5FD4441C0D39878AB7A3A4DC07C584B7C074541C05340F4056D3A4DC070ED138B0E4541C0C850FCCC5F3A4DC0B989128B144541C0B6F2402A4F3A4DC07A7B8F4E1C4541C0BF077EA6433A4DC0F27CCCF3214541C0CF2E2900363A4DC043BA83A8284541C02EFCC32E2A3A4DC0128EE7382D4541C0E8BCD5681C3A4DC0FAD2CFC5304541C0B5071AF0163A4DC06E4D5D5A324541C07207498A013A4DC0A0510389384541C0203D08FEF9394DC0FF00CBEF3A4541C038201A73F6394DC04F6EA5103C4541C0D22FBDCCE8394DC0B0153EA6404541C019489AA2D6394DC0534548B3474541C02F413564D2394DC077CE3A59494541C0A13E1FC8A0394DC05B8F880D644541C0B0C4A14881394DC0DB4AA9BF744541C05C0A6C3394394DC0FD14A8FF8C4541C0976A2406B7394DC03ED7EFA2B94541C0CA142458C1394DC02FAEECA0C64541C08F4BAAB3DF394DC077DC67CFEE4541C09D5527A2113A4DC09DF1317A2F4641C041552EA5203A4DC0D0BF12C4444641C05F67205A223A4DC00C2B3E2D524641C09969FF2E093A4DC065BB9FB3674641C0EC3E6C58FF394DC00A1662DD734641C04871FDDBFC394DC06EC3B4F0764641C07709E608273A4DC0DCB632528D4641C0153FADC4A53A4DC08DD39D7BCF4641C0EAEBBAFEA53A4DC0F7C9E199CF4641C04A823E3AC73A4DC0FE47AECBB44641C02CC93A59ED3A4DC06056CF86904641C0372010B40E3B4DC05628B9D56D4641C00BB7F962293B4DC013AC76B84C4641C056F93C05453B4DC06F4E5773284641C005385283633B4DC09A1C9DFCF54541C0FB567892763B4DC0A8B872D5C94541C0D9A537D1853B4DC071D25EFCA34541C08942A4E5993B4DC0DB8FA569734541C071D66ABB993B4DC0E8183755734541C095941F1BA43B4DC05F023DCC584541C07417441A7C3B4DC0E3E842BE444541C050F714127A3B4DC0A59052B9434541C0E332509D5D3B4DC0F9578325354541C07A7104464F3B4DC045C2BE244D4541C04EFEFA9B483B4DC0A21D2DDE514541C0A6295918CF3A4DC08D8ED982D64441C0","NUÑEZ",5049.31497894,1435842.99343,9792,4779,5013,13,47
136,"0106000020E61000000100000001030000000100000020000000EAEBBAFEA53A4DC0F7C9E199CF4641C0B48D6698343B4DC079D29E091A4741C02F05EE29353B4DC01AE540551A4741C0F9BB56F8543B4DC06E6D1F80F84641C02B6180E5743B4DC048D04EADDA4641C0ECCEB07E893B4DC0F3059542C04641C034E50C089C3B4DC09FC37141A94641C02848CD53A63B4DC0BF7059799C4641C035F86898AF3B4DC04B8042B18F4641C036BBC6ECBA3B4DC0CE9724E9824641C0D9A67538C53B4DC05E890421764641C02ED76D43E93B4DC08ED9D21D484641C05B72B48FEE3B4DC048E64AE8424641C0D7BB8033363C4DC066508708E64541C0ABAA38A1493C4DC0D29545F2CB4541C0CECA7D6F5B3C4DC0FED7B508B44541C0EC24D760323C4DC05034C229A14541C0E76EA0F40C3C4DC006AA0FE68D4541C08E027C64F53B4DC09C5BBDC4814541C068B624F5B73B4DC06AE785BF624541C095941F1BA43B4DC05F023DCC584541C071D66ABB993B4DC0E8183755734541C08942A4E5993B4DC0DB8FA569734541C0D9A537D1853B4DC071D25EFCA34541C0FB567892763B4DC0A8B872D5C94541C005385283633B4DC09A1C9DFCF54541C056F93C05453B4DC06F4E5773284641C00BB7F962293B4DC013AC76B84C4641C0372010B40E3B4DC05628B9D56D4641C02CC93A59ED3A4DC06056CF86904641C04A823E3AC73A4DC0FE47AECBB44641C0EAEBBAFEA53A4DC0F7C9E199CF4641C0","NUÑEZ",4018.35072893,703315.358816,14638,6797,7841,13,47
137,"0106000020E610000001000000010300000001000000120000002F05EE29353B4DC01AE540551A4741C01B0FBD240E3C4DC01C96B2028B4741C0A0B946EC443C4DC03205C4D84C4741C0A8B8E02C793C4DC0009666D70A4741C0C94C219F9E3C4DC0519D25FCD94641C05AFD9480BA3C4DC02D4D99B2B54641C04D25AAC8ED3B4DC049B739EA434641C05B72B48FEE3B4DC048E64AE8424641C02ED76D43E93B4DC08ED9D21D484641C0D9A67538C53B4DC05E890421764641C036BBC6ECBA3B4DC0CE9724E9824641C035F86898AF3B4DC04B8042B18F4641C02848CD53A63B4DC0BF7059799C4641C034E50C089C3B4DC09FC37141A94641C0ECCEB07E893B4DC0F3059542C04641C02B6180E5743B4DC048D04EADDA4641C0F9BB56F8543B4DC06E6D1F80F84641C02F05EE29353B4DC01AE540551A4741C0","NUÑEZ",3178.12401899,616866.871015,12488,5742,6746,13,47
148,"0106000020E61000000100000001030000000100000025000000A66477F4A4384DC0B113A500274841C0E47B8AC079384DC03CCED5BA464841C0B098F3D454384DC06DCEDF42654841C087866B112F384DC0AF52C67B844841C0D6BBCBF61F384DC01A7A240E934841C0842F77DB10384DC0B4F4023DA04841C013ABFEFB0A384DC06B1D642DA74841C032789EADF7374DC0858C24EFC24841C00A79F4A3F2374DC0666F4709CE4841C0BBD85E6DD4374DC0F6475D42ED4841C0E427321BA7374DC00455D6E91F4941C096428FED8D374DC0ABA91FE4384941C0040DED155E374DC087503A8B6B4941C0ED1F80E43D374DC0406DDA7A894941C0FC3BB5823C374DC0AD9BCBC38A4941C0A5019B4938374DC07CE1278A8E4941C024FADA9145374DC0429A761D924941C0989832AF67374DC036B1B0F99A4941C03A228B248D374DC011F73964A44941C05323E892AA374DC0F7D695B2AC4941C062D1F4B8D6374DC0B696DD53B84941C074769E24F0374DC039A868A7BB4941C02398C33A0A384DC0D24DBC6CBE4941C05EBDDBAD2B384DC0A31C726EBE4941C0121F156D42384DC0B84C41C7BC4941C03625668D66384DC08E971DB2B64941C0CB5EF2F87F384DC0283F299DB04941C0091CD0BF9E384DC0A623D2A8A64941C0732D18D5B6384DC0608657429D4941C065BE5008C6384DC0C4647486964941C086A5A8DE69384DC0363469D83A4941C0531747B8B2384DC02A1F37A8134941C00CDBED0B0D394DC0E927B6F8E64841C00A959A307A394DC026F9206FAF4841C04ED10DA754394DC02D0FBDB98A4841C0AD883019A8384DC08FE5AEFA244841C0A66477F4A4384DC0B113A500274841C0","PALERMO",4826.22857971,1008574.94787,21337,9753,11584,14,34
149,"0106000020E610000001000000010300000001000000AB0300003B093C43C8364DC06A1FFC9F974641C054F16608A0364DC00418CB94A84641C05A266C3B8F364DC04100AFB4A44641C0A2A92B7074364DC0500F8D6CAE4641C0BDB8194557364DC0DD2AF5B9B84641C0B1F896484D364DC00DC6B80BBD4641C02F9A76871D364DC0B259CC45CA4641C0E0F896F41B364DC0AD738204C64641C066B4901D0B364DC0A25C5731CA4641C0E5D1B5840C364DC0FAAB7741CE4641C03E6CD145EC354DC002A00E4ED64641C09A51F757CF354DC02EA5E28DDD4641C00C7EA06CC8354DC07D5FFE46DF4641C0DCABA3D7C2354DC0DC12CDB0E04641C0CE9A6C5ABE354DC0D24071C1E14641C085A9EA1CBB354DC053681388E24641C0D8E76049B9354DC0AE7C60FCE24641C0CA0E38B8B7354DC01AB1CA5AE34641C03A8C0C6FB5354DC005500CEBE34641C030212387B1354DC0164484E0E44641C0156F503BAE354DC0B05C37B0E54641C0ABE61F09AB354DC01A98D273E64641C020AFE174A7354DC00D608481E74641C06650542BA4354DC093F9D842E84641C0BF5013AE9F354DC046C2BA71E94641C009F8C2949A354DC033DC27ABEA4641C045F713C695354DC0D732D0E0EB4641C0EB4AD84891354DC08E5FAD0CED4641C05202CAD28D354DC06DE354D9ED4641C089D36C1289354DC05DA3770AEF4641C019D452DB84354DC0C31B1115F04641C0AF50184781354DC0348AA8FAF04641C02CB11FB57D354DC0964F1FEDF14641C08253188A79354DC04D973EDDF24641C041E0F0F074354DC0B73A1809F44641C006291DED70354DC0451A5E08F54641C051402CD46C354DC0C314310FF64641C0C46D8DE667354DC04232296CF74641C0659BEC5163354DC0C8EF0198F84641C07AE850955E354DC0AFA51EE8F94641C017515D825A354DC01F772E0AFB4641C0077DC83857354DC0BB9DD7F5FB4641C0062B987452354DC059FED571FD4641C0C4EF8A6C4D354DC0B47C31FFFE4641C08BA6293949354DC0778E4443004741C0567B89AD44354DC0C057ADB4014741C00D6DF3CE3F354DC0DFCABF58034741C0EBEF528E3A354DC08D3A4C1D054741C056FCF9F934354DC0B9ACBEF7064741C0CFCB44C130354DC0E23A9F80084741C015C45F672C354DC0CD8BE81A0A4741C07F36245828354DC0D8CE4DA20B4741C062EA7B2824354DC0F253DB3E0D4741C0C14AD8D01F354DC0011FF5E20E4741C04A5932511B354DC054C16CB4104741C0DC07EE3E17354DC05AF7794F124741C06D43F07F12354DC054B00249144741C013EC35750E354DC0C40E7AF8154741C05997F99C0A354DC04A4C9DB8174741C062B3A12E06354DC0551560CA194741C04B162A0A02354DC0CABBD20B1C4741C00E8607A6FE344DC09FB632E41D4741C0BFE2162DFA344DC03CAA2065204741C0C3AF470BF7344DC08BC0A549224741C06761EE26F3344DC0BC83A654244741C07E1923A6EF344DC0D5AEDF39264741C06A265C56EC344DC05F0C790E284741C038A58C00E9344DC090EB45C0294741C046295C68E5344DC0C30329B92B4741C06FDDB075E1344DC07004E3C12D4741C03E767D36DE344DC0C63139942F4741C0315B366CDB344DC0FE854A23314741C0A078CCDDD7344DC094C9E319334741C0A223A859D5344DC0D2587988344741C0E50EFA77D2344DC01BD10B38364741C0CCB27083CF344DC066BDC6F9374741C02F0BB778CD344DC0C85CDE28394741C0C7CA3C17CB344DC025A327B13A4741C00504CD06C8344DC005EF99703C4741C0B097E284C5344DC0BDE6BE053E4741C0D6A92F78C2344DC0E68250F03F4741C08CE754D7BF344DC081AACAAF414741C0B21A033BBD344DC05F097465434741C04B1052E0BA344DC0FB5466E2444741C00DF8773FB8344DC0828D9299464741C05055B434B6344DC08D3DE0FF474741C087F27153B4344DC07C83DF41494741C072E929EBB1344DC034485CDF4A4741C00EADFA79A9344DC0649DAEC8504741C0FFD54F36A0344DC09C4B0553574741C0CB3162669C344DC02BB802E9534741C071DC3C2793344DC0717B7CA2554741C0C6E1D7F78F344DC0E408E7BC524741C017150EF390344DC0153C42EC514741C0311C27998F344DC09AA8ECCB504741C01414DA837D344DC07D2F4757404741C045C9202B7C344DC0AED6113D414741C02352410E7B344DC01C1B6449404741C00D93CA117A344DC01BE480753F4741C037D4474379344DC000B260DD3E4741C0026C527F78344DC07E3349643E4741C05BE6E12778344DC0752FDC363E4741C04225E2F677344DC06EE8A31E3E4741C0E593E3C577344DC025A2EB073E4741C022A3259477344DC0F1D136F13D4741C0AABD616277344DC0A35E04DC3D4741C0ED1A1F2F77344DC05B35CEC63D4741C0C0E09FFC76344DC0A66720B33D4741C07E329CC876344DC04740719F3D4741C0B331599576344DC02DF4838C3D4741C07DC7956076344DC0964F157B3D4741C043A6CC2B76344DC01B64AB693D4741C0701C09F775344DC0AF1002593D4741C0D95345C275344DC0BA77DD493D4741C0B817FD8B75344DC0A0F9B33A3D4741C0CE1A745675344DC00DE24F2C3D4741C043C92F2075344DC040136E1F3D4741C0DA2EE7E974344DC044728D123D4741C0F4F6DEB274344DC08D192F073D4741C0F451D57B74344DC08963CEFB3C4741C0AB92C84474344DC01F96F3F13C4741C0B24FFF0C74344DC09BB318E83C4741C0342DF5D573344DC0D043C0DF3C4741C0CAF92C9E73344DC04DB32AD83C4741C034249E6573344DC02BA455D13C4741C08044D42D73344DC0439F43CB3C4741C0619E46F572344DC09E90EEC53C4741C020807CBD72344DC001E95EC13C4741C0DE9AEE8472344DC010C38FBD3C4741C0D6DE644C72344DC0F69183BA3C4741C0B72DD51372344DC0B5BDF9B83C4741C0D8324BDB71344DC0581871B73C4741C0EBCFBCA271344DC0EE09A9B63C4741C04E09316A71344DC0C98764B73C4741C03548A23171344DC0B99CE0B83C4741C0E78613F970344DC0EFDF5DBA3C4741C0A7CF88C070344DC018815DBD3C4741C0B657BD8870344DC0E62B20C13C4741C008AB2C5070344DC02E58A3C53C4741C0DB4B9D1770344DC0F2D5EBCA3C4741C0BB75D1DF6F344DC06E75F1D03C4741C0DC7F05A86F344DC04409BAD73C4741C03BD83A706F344DC0AE3443DF3C4741C051CD68386F344DC0BA1951E83C4741C086E69D006F344DC0EAD05DF13C4741C08AD190C96E344DC01A632CFB3C4741C0ABEA84926E344DC061DE80063D4741C01063385C6E344DC0CF11D3113D4741C0E7CF2A256E344DC0468DA71E3D4741C00809DEEE6D344DC07C4C7D2B3D4741C0326250B96D344DC0817ED5393D4741C08751C8836D344DC07A02F3483D4741C0108B3A4E6D344DC0BECB0B583D4741C0A19A71196D344DC06965A9683D4741C0DC41A4E46C344DC00396077A3D4741C0FE8F9AB06C344DC028966A8B3D4741C0A39F907C6C344DC061684C9E3D4741C02D5C47496C344DC0FE15F0B13D4741C0876102166C344DC0719592C53D4741C06CCF76E36B344DC07B6FBDDA3D4741C02842F2B06B344DC0CE84A6F03D4741C07E5D277F6B344DC030808E063E4741C05B4E214E6B344DC0F9A8FD1D3E4741C0973F1B1D6B344DC02D4669353E4741C00E70D4EC6A344DC0A7BE964D3E4741C03A2D4EBD6A344DC013644B673E4741C097928B8E6A344DC0BE93FC803E4741C0C1D7C85F6A344DC051E6719B3E4741C024CAC6316A344DC05FB7A6B63E4741C0492FC3036A344DC0BF1F9CD23E4741C050BF3FD769344DC0473E95EE3E4741C0187EBDAA69344DC0925D0E0C3F4741C0E9E3FE7E69344DC0031E8B293F4741C0B589FF5369344DC0DDFFC4473F4741C0EF6DBF2969344DC0F176C5663F4741C029B6450069344DC03F1083863F4741C0638685D768344DC0293E07A73F4741C0F79FC9AE68344DC08AB286C73F4741C0C265CE8668344DC0D68DCBE83F4741C0FF37536068344DC099CECE0A404741C05DEAD73968344DC059D5932D404741C0FA43201468344DC0CE4E5B50404741C047A9E8EF67344DC0A6E7E573404741C046EFB0CB67344DC00DBB2E98404741C08BDC3CA867344DC030017ABC404741C0E1434A8667344DC0FAAC83E1404741C0F51C566467344DC083D85307414741C01F02E24367344DC085C6E42D414741C0A3E76D2367344DC004297254414741C0EC407E0467344DC04B42037B414741C0217B8EE566344DC0B26751A2414741C0DE521DC866344DC0CE3766CA414741C0402071AB66344DC0F4E33CF3414741C0BA91818F66344DC027254D1B424741C0C012197566344DC01CD8E544424741C021B9AD5A66344DC0CDD0796E424741C0C465C54166344DC024801198424741C055F2DC2866344DC000246CC2424741C054AB741166344DC0E238C2EC424741C06F59D1FA65344DC045B5DD17434741C02AC6ACE565344DC0FFD0F542434741C07A1288D065344DC0383ED36E434741C0E640E9BC65344DC0FFD6B09A434741C0751804AA65344DC019F98AC6434741C05AE5E39765344DC0425429F3434741C09526488765344DC05109C91F444741C0731FA87665344DC07732654C444741C00A488F6765344DC062AAC579444741C0FAC0F35965344DC06C7B27A7444741C097155B4C65344DC058C185D4444741C03A03444065344DC0588FE601454741C06EC2EA3465344DC026670A30454741C0EB04582A65344DC0A8262D5E454741C00306442165344DC00CB44D8C454741C0D065EF1865344DC0CCB370BA454741C01F925B1165344DC095F794E8454741C09BA64A0B65344DC0D7727617464741C0595D000665344DC0A8C99945464741C01C9D6F0165344DC054FB7E74464741C0D5F2A3FD64344DC01BE661A3464741C0197458FB64344DC0CF5847D2464741C03874CCF964344DC0D81A6B00474741C072FC03F964344DC054E7512F474741C00B1FBDF964344DC00D25345E474741C015E939FB64344DC018041A8D474741C0231276FD64344DC0082701BC474741C0FD67320165344DC00DBBE3EA474741C09EF2B30565344DC0782A0819484741C02F06EF0A65344DC035A3EF47484741C08665B41165344DC010C81076484741C012BB341965344DC05D53F7A4484741C0CC457A2165344DC01C5D1DD3484741C098307F2A65344DC059C23E01494741C0F246043565344DC0FFDD632F494741C0EB244D4065344DC0EB77C85C494741C023B0564C65344DC07AEDEE8A494741C0661ADF5965344DC0DD0D4FB8494741C0A6992C6865344DC033FEB3E5494741C089053B7765344DC0FF3D57124A4741C04E44078765344DC0349FB73F4A4741C09D84599865344DC0D31F5B6C4A4741C0FF436BAA65344DC0C5EF3C984A4741C0E3433CBD65344DC042E1DBC44A4741C0AD2FCED065344DC01EDCBDF04A4741C03FB0E4E565344DC0513CDE1B4B4741C0F3C3F9FA65344DC0E310FB464B4741C09DB9941166344DC0F3CA1C724B4741C05AE6EA2866344DC0E719789C4B4741C0A887C54166344DC0B11FD7C64B4741C0FA71A45A66344DC0EB2536F14B4741C0EA11FE7466344DC0516D0F1A4C4741C0BCA71C9066344DC0B9EDAC434C4741C0EF7200AC66344DC084EC896C4C4741C039759FC866344DC02F80A0944C4741C03FD6FDE566344DC019E3BBBC4C4741C08915E50467344DC0592012E44C4741C09DFF0B2667344DC03463AA0A4D4741C0E3A00B2667344DC0F486EE0C4D4741C09B7D939867344DC02E15337F4D4741C0E962DB7769344DC0939DA03A4F4741C0F197CD4168344DC0F3B37B26504741C022F3C9DD68344DC0E476FCB3504741C0DA88FFB37B344DC05E102DD2614741C0E47EC4B97C344DC0979AAF13614741C002BD34F27F344DC07BDD52FF634741C0D3F359E87C344DC0405C9C7B6B4741C0D79675AE80344DC07BCB9FE56E4741C0FAE8F0A67D344DC043212F49714741C044DD44087B344DC0231E7366734741C0B73B607078344DC09091C389754741C04DCE7ED875344DC0D23AD58E774741C09C6757EB72344DC0971CD2067A4741C0FA0475D56F344DC0E2F13E967C4741C0ED834F946D344DC0718EFA8C7E4741C033F969D46A344DC0881785EA804741C0ACE2F43768344DC04D33A130834741C0314967DF65344DC0E9DA9342854741C05382711663344DC0A31781B1874741C0AFD039F85F344DC01C4788898A4741C0E31734AB5C344DC072AB0B7F8D4741C03F0308ED58344DC0560B14D9904741C0718F084C56344DC09C72733D934741C02754F6F453344DC0318D5384954741C0BA98385552344DC08197B80F974741C0864CFB8B50344DC061EB50D2984741C051791B594E344DC0468721F19A4741C062FED0D94C344DC034DF4B7D9C4741C0FF58EDD14A344DC0A9F08B919E4741C0752E210149344DC0B73E7A5FA04741C0D5988CD946344DC011BA18A1A24741C045235DFB43344DC0624C3AA1A54741C050805FB941344DC0395D280AA84741C0B68BEA5D3E344DC04211C7A3AB4741C0FF94C55D3B344DC066FA72C7AE4741C01615A1E537344DC0F45E7E94B24741C040B298CB35344DC0A90876E1B44741C0A9C5DA0934344DC0C3A51AC9B64741C0D1F517C731344DC0BBD27D49B94741C034B3394D2F344DC05887BBF8BB4741C0C6A9FB0E2D344DC0F013C26DBE4741C01ACEA0E62A344DC0BFF10FC6C04741C0FD51E2D128344DC0C6486402C34741C03238B24227344DC0E7F2B0BCC44741C04C4CFC8325344DC07C5811A2C64741C07B934A2823344DC09DCF064CC94741C07CB6549F20344DC06AE0CA1BCC4741C081256D221E344DC0D4B00CEACE4741C007416E431B344DC0064C370CD24741C01CAA83C318344DC01ABE20EED44741C056672AFE15344DC0FDDA020BD84741C0037FE36F13344DC0AA2FC6F9DA4741C08F5798DE10344DC09BC2F7FCDD4741C0B45368020F344DC00BC0531DE04741C0700741B10C344DC0644538DDE24741C0486ACB750B344DC0B9DEF751E44741C0C3083AA306344DC0F08AFEB4E94741C0B34368F502344DC000016409EE4741C07A48058000344DC0B8DDE8F5F04741C0042C037CFD334DC04867CE72F44741C0B4F6B318FB334DC0DDF59661F74741C05A6424DBF8334DC09957351CFA4741C044B4AF5CF6334DC040EAE01DFD4741C0365DA1CDF3334DC02E7F1121004841C0C83A3330F1334DC09516EA56034841C050BBDBD3ED334DC015490868074841C0CBABAEE2EA334DC0D47234E70A4841C02D3B7FF1E7334DC07E9F4B790E4841C076033CCFE4334DC03DEB5846124841C046F17CFEE1334DC0164180BF154841C0603B0B33DF334DC021737F0A194841C0FBE88CD9DC334DC0F0060EDE1B4841C0262B5C3EDA334DC03A0ADE2C1F4841C07781F5FED4334DC0F4A485B1254841C0565BA91CD3334DC0981B8820284841C0477A9145D2334DC054E33A32294841C000E404CBCD334DC02D5B67DB264841C07F7FE986C9334DC02FD8763B2C4841C09905FD4AAB334DC0593A56C41B4841C0916E1984AD334DC0BBCB8CD5184841C099B06B7CA2334DC07B6F1DC4124841C0C2DA1A1CA0334DC04FB282C0154841C0C1E6FE0F80334DC089213431044841C00BA451B64C334DC00018253EE44741C00949D59E37334DC0966A86B5D64741C09006F44B36334DC0D9915E39D84741C0144E69F648334DC044DF1133E44741C07524C0B17B334DC0434BB7FB034841C01991D2D99E334DC056FE8456174841C07BA187AA9C334DC0426E87411A4841C0911467D9A7334DC056324358204841C00B85F235AA334DC0CB4671631D4841C0AC475B3CC8334DC0A12460C52D4841C0444D0602C4334DC093FA002D334841C099BE0C7BC8334DC0CC697191354841C0A83E0B52B7334DC025E2CA394D4841C0D83344449F334DC01B82B869484841C00C7CD6939E334DC0AA4BC63D484841C07393D5D59D334DC04E3D010B484841C0AF6180069D334DC09675A9D0474841C090C1EDD89B334DC0ADD4C778474841C058EB00079A334DC07F4697E9464841C07729149198334DC0BCC6D96B464841C0FD5772B697334DC07F94531C464841C0F23589A596334DC0A65E11B3454841C0D813E2C495334DC0F76B2D55454841C08B54A26095334DC067527F28454841C0FB6CEB7094334DC006C21DB0444841C003ABDE0294334DC029954871444841C05BE7536593334DC0D597200E444841C029B867DB92334DC04661C0AE434841C08C4C617392334DC0CDCB8D61434841C0390FED1292334DC0B5285C14434841C0B348757E91334DC02EC2BA96424841C0A0C7E19D90334DC0A4069FC6414841C018D1B7DA8F334DC0A3AA5B00414841C08A4E21598F334DC0F1DE9D73404841C01CAE05A28E334DC06ADBFD9E3F4841C08DB27F2C8E334DC028BF350F3F4841C0C3A3841C8D334DC0F18F53A93D4841C04A239C4C8C334DC04B14BC803C4841C09F871FA38B334DC076BBF27A3B4841C03A93D65A8B334DC025CE10F83A4841C056B5C1028B334DC08BDBDA313A4841C0DA77BD708A334DC0705B4DB2384841C01CDC580D8A334DC0D3976CD8374841C0248A4E8D89334DC09273D303374841C04EC3FC4489334DC0AFF2E499364841C0CDE378D288334DC03FC1D001364841C0C306F69688334DC0BDA029B9354841C00115E31988334DC05BEE2C2D354841C0F5FBADB887334DC03A6D0CCA344841C0D3538E3587334DC013FB3550344841C0DC4DBBC086334DC01BC5D4ED334841C045AE58D685334DC00B95F138334841C0E8E0A6E084334DC0CFEA5C8C324841C05158170C84334DC0EEB1E507324841C0AD4D695383334DC05AA730A0314841C0DE893FD082334DC07A00915D314841C0E7A6A95D82334DC0200CCE27314841C0CD0AAEFE81334DC0FFCE65FD304841C0E0C46D237F334DC05FA260DE2F4841C030208FC47C334DC02371F5FE2E4841C08C5BCD8B79334DC0099BE0DF2D4841C0189A28ED77334DC09CC580542D4841C063C1B9A676334DC09A6C75EA2C4841C05D72058F75334DC0671054932C4841C065154AD374334DC0AC1B475B2C4841C003870D2773334DC0CA07CDE22B4841C07F8C6D9171334DC04C2E8C822B4841C042E56D266F334DC0DBCBA3012B4841C0688BA4026E334DC0A976EFBE2A4841C0AF4E8F016D334DC034FFBB7A2A4841C05F02CEF16A334DC0BB35EFE0294841C012E1A5436A334DC0F2EAADAF294841C01FCC66B469334DC020E84F8B294841C0A3C4AB3A68334DC004DAA835294841C01BE84C9B64334DC0F4609C79284841C074DC4CA661334DC063A48DEC274841C0A07AD21D61334DC064D989D6274841C0AA7ADA0660334DC0F3FAD4AF274841C090C4CB4D5A334DC0B819390D274841C0E5C1EAA757334DC07F8A5FD0264841C02FF307EB55334DC04411A2AF264841C0A5CF2BEF54334DC0BB21F2A7264841C0696274B253334DC084FCD4AD264841C0D4857DA452334DC074F8D1BC264841C02CDDE0D851334DC0F04D99CC264841C07CD25F3C50334DC03916C0F6264841C0DD5CFC8C4E334DC0884F1136274841C071A293614D334DC0609D666F274841C066084BD54C334DC03A9F168F274841C041AA584C4B334DC0FA60FBF1274841C03E20357749334DC0FF8BDC76284841C06F144DCC47334DC0527A08FE284841C0281A917046334DC0E7116478294841C02B5661BB43334DC048E3747B2A4841C0DD875DFE41334DC0D0ACBA0E2B4841C0DEA870A940334DC08CDE2B762B4841C02D88D3B53F334DC0491E9BB82B4841C0AC067D203F334DC0E85E5ADE2B4841C07EBC4CC63D334DC082DF902A2C4841C030C0F4783C334DC05F55F46C2C4841C02E62919E3A334DC0DB152EC22C4841C0CC30C20B37334DC00139015C2D4841C04C52414735334DC02DA9969D2D4841C0958E3FF732334DC0CDDAEAE82D4841C010BA9D7331334DC05256EC1F2E4841C0E2DA63A62E334DC0E81042902E4841C0E46AB5CE2D334DC08AC67AB72E4841C048ECAF642C334DC084AA6A012F4841C0D9CB345B2B334DC0AE7A8B3E2F4841C0F0D1F2FE26334DC022171055304841C075A55F8D25334DC080E6FCBA304841C0B5E8C2F524334DC00C4C10EC304841C0AEBA632F24334DC0CF56D033314841C0FCC6BC6623334DC0E1D8DE80314841C04E21091122334DC034B8DC0B324841C01739153820334DC02EA08AD2324841C088E2DC641F334DC0FF47E527334841C06C8AA7E71E334DC073357654334841C0A7E5A4861D334DC01BF691CF334841C07D74EE071D334DC05968A700344841C07A57E4A81C334DC0EC69362A344841C0597B78601C334DC07153344C344841C03B7578DF1B334DC0D6B53B93344841C03DA7607D1B334DC0C5F7FBD4344841C0E9E3B43C1A334DC09DA3B0D0354841C0719817E717334DC0037FD4C2374841C077EFE8EB12334DC0ADC2DBCC3B4841C09C813FB810334DC0B93F82A13D4841C031125FD40F334DC03FF0AC573E4841C0D02196560E334DC0558D6C7B3F4841C02925F3790B334DC000144D93414841C047B385350A334DC021D78F77424841C0E18959CC07334DC0ADF4471D444841C03DFFE67D07334DC098A8A64D444841C0813C8A1607334DC0FD061C8A444841C0BDE7E1D205334DC04D40BD41454841C06A928D1B05334DC0E30F61B8454841C0DE4ECAC404334DC0D0B222FA454841C0E22DA85C04334DC0A457DB54464841C07F1BA63104334DC016B2AA7D464841C00C8EF1E903334DC003AEC0C7464841C0651F7CA103334DC0F5EE6519474841C054E3B22503334DC08323EFB8474841C0920D83E202334DC0C0D7B319484841C0387620A902334DC013C47274484841C06DFA6E6A02334DC04F9082F6484841C003091FFC01334DC0E37B53114A4841C00F443BC401334DC079BACD884A4841C0A5DE7CA101334DC027C148C54A4841C093A5B97801334DC0108346004B4841C09053BCA4FF324DC0E1519D5E4D4841C012E54F78FE324DC0E60A0DCE4E4841C0189346FAFD324DC071C0B7604F4841C0E72A1BDFFD324DC01F92F17B4F4841C05DFD39C9FD324DC03B3BD68E4F4841C0A6E4C1A5FD324DC0321C03A74F4841C083FF8A81FD324DC09CB32EBC4F4841C02EC27044FD324DC011375FD74F4841C0860D23E3FC324DC0B9B553F64F4841C071042087FC324DC0A7FEB50A504841C0ADF635E4FB324DC058141E28504841C03E08420AFB324DC0A2A51E53504841C0F67E38ABFA324DC07C6E9370504841C0468B1E6EFA324DC01763408A504841C09E4E8835FA324DC0CD23FCA9504841C0ED4CDA15FA324DC0A1B3AAC0504841C08D74D347F9324DC060562A7F514841C0B7B5AFDFF8324DC022543CE8514841C0094C7643F8324DC0ACE45995524841C08D89C23CF7324DC0DC21CEE5534841C00CAA21CAF5324DC03DBAF7CE554841C03676BC15F5324DC0B11644B0564841C06D5C8A5AF4324DC0C1BC4089574841C02BA1B488F3324DC084D84184584841C0E54BF137F3324DC093F756ED584841C030BB31EDF2324DC0223A3F5D594841C0BCE0CBB0F2324DC09AEE62CC594841C0478D2178F2324DC04905EA495A4841C0D58ABE44F2324DC077620FD55A4841C0A8ED3F24F2324DC0577F273B5B4841C0D80099D5F1324DC00B5FCB5C5C4841C0FED08678F1324DC0F6D6CA025E4841C02D786C31F1324DC0DFA7F1065F4841C09463DAC6F0324DC07F07C13D604841C0F79BF7EDEF324DC0365D628F624841C0DAA0E2A3EF324DC0E2056A84634841C0A1DD7592EF324DC05742F1E2634841C03B84E98DEF324DC07630920F644841C082194D89EF324DC0F94D5F70644841C011FA818BEF324DC0D7C602BC644841C05987E5ADEF324DC0EA107051664841C0259199B1EF324DC05F5661A2664841C0CDCE00B0EF324DC0BD467B08674841C0C731E1A6EF324DC026F5C867674841C0A314A38BEF324DC06506C7E0674841C032F8B875EF324DC030354D20684841C08CC1BF56EF324DC0CBFDEA6B684841C09FD122DDEE324DC000273C69694841C01B97FEA5EE324DC0ED1041E5694841C0F1D02096EE324DC0235DD90E6A4841C03E97E97AEE324DC0431F0E656A4841C06878C9EBED324DC0037331666D4841C0E67DD28AED324DC00A30A3996F4841C0D6D56376ED324DC027B58B06704841C066841336ED324DC003931119714841C02630ED0AED324DC0C506DAEF714841C0981FF7FAEC324DC099EA087E724841C02818ACF8EC324DC0A4C184B7724841C04E941DFAEC324DC0A893A401734841C074DB531DED324DC01B488135744841C0A55E9643ED324DC0FAC8CB26754841C05143B19DED324DC0596E581F774841C0685684FEED324DC0081FD96B794841C0CFD95689EE324DC06A8EE1E37C4841C03FCD9D9DEE324DC0877998547D4841C014CA27BAEE324DC0212F8FE37D4841C05AAD231BEF324DC0D7E513637F4841C0C52E4245EF324DC0C5FE0FF27F4841C056B3AF80EF324DC00D2917A3804841C0E0BCAABDEF324DC0527DB626814841C09511424BF0324DC053CA5D1D824841C07D168C93F0324DC0D08554A9824841C0595F0BDEF0324DC09C787C69834841C0C8B3D588F1324DC0CFF18C60854841C0FC248318F2324DC0C2A8A83E874841C089E8A757F2324DC06E5CA946884841C0E985F88FF2324DC0C9373472894841C022BB4AC2F2324DC0EA92586D8A4841C0E0431EDEF2324DC0B9530FDE8A4841C08346CF1EF3324DC00C2C8EA98B4841C099952839F3324DC02C5CA4ED8B4841C056A68F65F3324DC052D8FC4F8C4841C024A9E3B6F3324DC0807B56EA8C4841C0464551E0F3324DC01EDAB2308D4841C08D9AD924F4324DC012C05F9B8D4841C028FAAE71F4324DC019DD94078E4841C057A890C4F4324DC09B11C6738E4841C00D38331BF5324DC02446B1DA8E4841C08B18ECB4F5324DC0FC645C7A8F4841C0B0D2A217F6324DC0A3ABABD38F4841C0BC026952F6324DC07D16DB04904841C086610BA0F6324DC0D16E2942904841C0BFC5F057F7324DC09E8B5AC4904841C074225208F8324DC022E25E31914841C07DFC9E75F8324DC016D1E96A914841C0D186F7E8F8324DC066531D99914841C0C406AC31FA324DC0D325BC0A924841C0A0CA5685FA324DC003389A30924841C0A00865F0FA324DC0E8266A6C924841C03DC956E2FB324DC0FC3301FD924841C039DEA24FFC324DC0992AE341934841C0A9F970C1FC324DC0CA49568E934841C0B0F9093AFD324DC0F78F22E6934841C039BBCDD6FD324DC0C8298E67944841C0D61F9C4EFE324DC0486558DB944841C02A50FCED00334DC01D50F588974841C033A12AFC03334DC0395308839A4841C0E46D38DB04334DC060EB966A9B4841C05598223705334DC05FF8C0D09B4841C0B6362E1F06334DC0CDFDC6EE9C4841C0A25431CA06334DC05619B8CB9D4841C0D938CE8807334DC0D5860DB79E4841C065B945DB09334DC0DE7D545FA14841C04BDA09EF0A334DC0894B71A2A24841C06AD0BFC50B334DC0C2F947ABA34841C0340647380C334DC011768236A44841C09C6362870C334DC0F383D292A44841C02D2EBE090D334DC006135F23A54841C0913132400E334DC098E96F60A64841C065AFD9690F334DC04F099587A74841C01EFE5DB911334DC0573725DBA94841C00DF40E5713334DC002AA9F7DAB4841C08B1A3E8B14334DC05F6582C1AC4841C0466A76FF15334DC038169955AE4841C05041C4F017334DC0756BC17EB04841C0B135342719334DC0026C08D4B14841C06A3830041B334DC0BCF182CAB34841C000F314CF1C334DC073EBE298B54841C093C66AC41F334DC0AD976F75B84841C033D71ED422334DC053C0E180BB4841C05FF08B6924334DC08E849200BD4841C01E13FA2E25334DC0E37CD7C6BD4841C0B6D05FF125334DC0F70693A7BE4841C0B128BDE426334DC0ADAFA4C8BF4841C07EA663A927334DC0ECE5859CC04841C00231CF6B28334DC0AD55C35FC14841C0DC41DA1329334DC0D5F8B301C24841C00263F3C129334DC0CF9426A2C24841C00D7CC50E2A334DC03807B61CC34841C05E202DE02A334DC066438B60C44841C03C341B7C2B334DC027A8CE45C54841C0F58C1C982C334DC0FC5133C9C64841C0B79F82972D334DC0825C5D12C84841C06A4A081D2F334DC0127AD9F2C94841C0E500100C31334DC05E20F434CC4841C07FE1714633334DC0B43AABB9CE4841C0DF161C3F34334DC052CF92C8CF4841C0F95AABF535334DC0F0FC5F8FD14841C03E7CD58136334DC0C5260E13D24841C0DA4CA25837334DC0843DA8C5D24841C011C28C4738334DC076D9547ED34841C08FAFB66838334DC044FECE95D34841C07DDEB99C38334DC0E8B452B3D34841C05172E9F138334DC0C8F575DBD34841C0ED3C7C3339334DC01051C4FCD34841C0574CBF6639334DC03A57141ED44841C075BB6C8939334DC0C92FD53AD44841C0116A10A939334DC0B60B625BD44841C084E576C939334DC0A31B0388D44841C0866B93E439334DC064FB76BBD44841C01C1F5EF139334DC04E3000DCD44841C081BE327B3A334DC0DFD482C3D54841C0B30AB72C3A334DC0B7267E01D64841C08631C46439334DC00EAF769FD64841C0B2590C9C38334DC0DF0EB23CD74841C039E313D437334DC046CBE8D9D74841C0C5245C0B37334DC0E75F6276D84841C02420E54136334DC0E7581512D94841C0F8CC6C7835334DC098B707ADD94841C0D206F6AE34334DC0DD4D3847DA4841C0578BBEE433334DC09A8DAAE0DA4841C0FF0B831A33334DC03DE19678DB4841C0F28E8C4F32334DC02625C00FDC4841C0492DBFF531334DC00A934452DC4841C039C975D024334DC0A57A2DADCE4841C07B2520B523334DC0765DDF8FCD4841C03FA869AC21334DC02D44888CCB4841C01C7E036E1E334DC0D8D52333C84841C0FA4671CB0F334DC0B25BA12FB94841C09763572307334DC0CB152A36B04841C059573BBCFF324DC0F4387F93A84841C01DBB914BFD324DC0559FD017A64841C0AA0494ABF7324DC0B0A5196AA04841C03ADB3CA0F3324DC0D87ACA589C4841C07D10F74FF1324DC0080B2CFF994841C0B0FCDBD2EC324DC0498D0C58954841C06FFE6DA9E4324DC06B2045C98C4841C04EEE7F4AE4324DC06D8D075A8C4841C0DDA990B4E3324DC07051D3B58B4841C0C3298E49E3324DC083DC55478B4841C01B4E681EE2324DC05C00F5208A4841C04B29526DE1324DC0B0E68580894841C0DB9C27E1E0324DC051CBEF08894841C0844D9C71E0324DC0EB141BAE884841C0A4F18F98DF324DC072A0DD09884841C04DF228AEDE324DC0D0E0A468874841C0CE4F183DDE324DC086268527874841C094BF55A9DD324DC0D6869CE2864841C0D5F36150DD324DC0A108C7BF864841C0C98E14E6DC324DC06A7AA79A864841C0DB441253DC324DC02F55F56D864841C04EF06705DC324DC053B68059864841C0852D3723DB324DC03B62FE2B864841C0DDC12F62DA324DC0536FB316864841C0E3CDA8D3D9324DC03132D812864841C01478422FD9324DC075DE0C18864841C0A318CFAFD8324DC08DD61121864841C0AED2044DD8324DC09EF7D82A864841C06516C195D7324DC06454BA46864841C0164C023FD7324DC052FAD858864841C03B65B1D2D5324DC05FBD6EB6864841C0FA9E11D7D3324DC06139B24F874841C03D79934FD2324DC0303312D0874841C087543205D1324DC009E9E245884841C09E057C33D0324DC04177FE9B884841C058675D47CF324DC07B37D60E894841C030839F4BCD324DC0C1C82B278A4841C0137CC4E2CC324DC0B100105C8A4841C01A3172A3C9324DC03BE938CE8B4841C07A7504A8C6324DC069022A1F8D4841C0878E73BDC2324DC01EBDE2DF8E4841C033BC77BBC1324DC0701E80568F4841C07A741B7FC1324DC059F539768F4841C08589AC36C1324DC0B273D1A28F4841C04E2F3010C1324DC0BEDD04BE8F4841C000E081C8C0324DC00963BCF98F4841C0B1557144C0324DC0CDF47C79904841C0A1E131DDBE324DC09DC129EB914841C00A4A7388BA324DC04AA5E79A964841C07827DEA0B8324DC0DF3BDFAF984841C0E153C4F4B7324DC0D82CEC72994841C00186802DB7324DC050E8465D9A4841C084F16BACB6324DC0ADA9D4FF9A4841C01C15BDA8B5324DC0F8F796589C4841C0F69E8DF7B1324DC0F5307868A14841C00D74535BB0324DC0D31D16C6A34841C02BBD1603AE324DC0D0D45248A74841C0C1D8DED2AB324DC0C359EE7EAA4841C073463925AB324DC02764AF77AB4841C092298A96AA324DC0E4E37335AC4841C0AB2F71F9A8324DC0DCE4EA7BAB4841C091DDFCD5A7324DC04AC9863BAD4841C0763E4666A9324DC0BC3002EFAD4841C00A39A3FCA7324DC055AE3F00B04841C0473F33CDA5324DC0843FB524B34841C04C7E84E2A2324DC07698024EB74841C0F27D33AA9C324DC0A7281C59C04841C03663B08797324DC0D90C9117C84841C02E16945397324DC03B0CE27CC84841C05D7C0D0E97324DC0B9A54C29C94841C06A09B8E396324DC09AF558A8C94841C05C24AB9F96324DC03522F188CA4841C03B01386C96324DC0F923AB59CB4841C0B726A84B96324DC022977EF8CB4841C02C11E51896324DC0EC4E5813CD4841C053AA860D96324DC068BC4F6ACD4841C04B5A950096324DC0BAD2E106CE4841C04010C1FF95324DC0218C3F50CE4841C0796EA70E96324DC06675E330CF4841C0EC9A413396324DC0AB0B11E3D04841C007C94F5396324DC0208545B7D24841C0CC37905E96324DC0982FF005D34841C025F6895E96324DC075073024D34841C0E47E7B5896324DC0BA273343D34841C0557B6A4F96324DC00F079D57D34841C072068F3F96324DC04E4F9573D34841C04CB0262896324DC0589D1391D34841C0330A091696324DC0C56EBAA4D34841C0ACF853F395324DC041AFBAC3D34841C04A05779095324DC030AB4E0FD44841C0B03CBE4295324DC0E8455653D44841C0C42A7C5192324DC07CF6DA6DD74841C0D39428F48F324DC0CAFC05DFD94841C07F95A39A8D324DC067053131DC4841C0316684EB8C324DC01E0930EEDC4841C0AFB27C958C324DC09DCAD23FDD4841C0859D1D818C324DC02E445F47DD4841C01CF9CB728C324DC00A8DA249DD4841C0014390A38B324DC07746F48DDC4841C0E48800C38A324DC06AF58BBBDB4841C0217DE4798A324DC099A4D085DB4841C079C867198A324DC0D1DC4D4FDB4841C0A0DB94A789324DC038FA4A1ADB4841C0F49D28D187324DC026F0914EDA4841C0CBDE465687324DC0C26F6223DA4841C0FA54563187324DC05E7B8819DA4841C0EC86EEE586324DC0170A9C09DA4841C0B47EFD9286324DC0EDFA37FED94841C0E83BBF3786324DC041ECE0F8D94841C09125E1F685324DC0C0ACD7F8D94841C07CF14AB885324DC0B91D51FAD94841C0F1E0815585324DC0CBCE1101DA4841C0BC5769ED84324DC04ACA1B0DDA4841C0C80C9E5F84324DC07CA2852ADA4841C0B622BAED83324DC0AF01044EDA4841C0FAE5E7B883324DC02E716662DA4841C02226764283324DC07BDCD29BDA4841C0846A52D782324DC093884BDBDA4841C0FE5CE69182324DC0DD642E0DDB4841C0B60F8E2D82324DC0F822C95BDB4841C09EC773CE81324DC097896AADDB4841C00ACDE17381324DC0D90A9603DC4841C0B5096A0081324DC0D5330D7EDC4841C0E475739A47324DC0490CBFE53D4941C0671285F046324DC0837410053F4941C0A46BCE7D54324DC03AAD29433E4941C083C29E0663324DC071EDE0223F4941C0F412E1046C324DC07D88C901404941C025F475077A324DC08313ACE0404941C064B6DEE788324DC01A24FF54414941C07F6FBF278F324DC0318430DA3F4941C02429A75C94324DC04D849B4E3E4941C01ACF1B9DAA324DC08F4A27BD314941C08D0D3E03C1324DC0AFF7C415254941C0999FDC85DB324DC0055875E7154941C0B6E25E50DE324DC0A707A74E144941C00F60CBA2F4324DC09F64A786074941C0BAB8139AF9324DC01F967CB3044941C0AE462A8706334DC0CCD42359FD4841C09775A3C41D334DC067CCEE5EF14841C0B740F53B32334DC01D7331D1E34841C0D8E0B9B234334DC0FBCF0130E24841C05C84023437334DC084A065B5E04841C06FB8BFDB49334DC043D75EB3D54841C07126D17358334DC024025918C94841C0938AF0AB6F334DC0586BB844B44841C08E286C9581334DC0D5CF9CA1A14841C073117F348B334DC0B1B83A79944841C0D7215ED88F334DC0E32D68C4974841C0B11554199D334DC02C0528E79E4841C0FB5E8855AE334DC0EE84FA759F4841C0A6BEBCEBBC334DC01EF2322D9C4841C0C0E137D0D0334DC002CDE8F5934841C0AF977F54ED334DC039EBDB11844841C0D873D2EDF9334DC00AB029B07F4841C0ED29CFD907344DC0ACB020257F4841C0C1716BC515344DC0C10511CC804841C02CC4BA5F20344DC05BF864EE874841C09F0AF6E834344DC0AB2D753B9C4841C09B68970261344DC0D0237E50864841C01EB0E4DC7C344DC036FFC4F8764841C07403FA049E344DC03922C457644841C0619B99CBC7344DC0E7C6399E504841C09BFD3EC1CF344DC0DE5280224B4841C04F22283CF2344DC0E394FD253A4841C0BC15740818354DC09C1CD36B264841C0101183F525354DC03B7897A71D4841C06071A0CC43354DC0CB8BCF910B4841C088C5C4C14B354DC0C1C7EBD3084841C0D28CFCB553354DC057752830074841C08A4CD70359354DC0A00C34D5084841C03486D71BB7354DC065E69173534841C0FA112065BB354DC0257DC333644841C01FB74EB6BC354DC0E9FA3F53634841C06CF62B0CBE354DC01009F232674841C030CC56B9C2354DC0039CFB7F6F4841C0D88160BECA354DC019236FE37D4841C0F40AA2C8D7354DC0FE945016854841C038183B83F0354DC05CEDF5B3AF4841C0B74FF93903364DC0D885B83FCF4841C01B34B44F21364DC02A6AD859EF4841C07353364F27364DC081BBCFE9F44841C0EE405D083C364DC01A37F62C034941C0B42C690549364DC070EBDB860F4941C097ADCF3B55364DC00C564AD71E4941C03BC71CB9B2364DC0C6CABD89524941C07B950669DF364DC082F2F522684941C03B47A883F8364DC0430F7D4D734941C0992B5FDC07374DC005768685784941C0ED1F80E43D374DC0406DDA7A894941C0040DED155E374DC087503A8B6B4941C096428FED8D374DC0ABA91FE4384941C0E427321BA7374DC00455D6E91F4941C0BBD85E6DD4374DC0F6475D42ED4841C00A79F4A3F2374DC0666F4709CE4841C032789EADF7374DC0858C24EFC24841C013ABFEFB0A384DC06B1D642DA74841C0842F77DB10384DC0B4F4023DA04841C0D6BBCBF61F384DC01A7A240E934841C087866B112F384DC0AF52C67B844841C0B098F3D454384DC06DCEDF42654841C0E47B8AC079384DC03CCED5BA464841C0A66477F4A4384DC0B113A500274841C0BE4DEA95A3384DC0422F8038254841C089AEBD2B82384DC0376CDCE5004841C071AE338378384DC0C4130BA4F44741C07E614E0278384DC0B7D26701F44741C0C290980163384DC010062C5DF74741C07A40199646384DC02012C8EFFA4741C066EA87D643384DC0DA582748FB4741C00E8A86D328384DC01DCF701EFE4741C077CDC7911E384DC0E7DBBE32FF4741C0FC9413C706384DC01C2F5E49004841C06BA65CFBF9374DC0E79434DF004841C0997FA355E6374DC0CD0F9600024841C0AB15B9D8DC374DC099EEFD8B024841C045E12D33C9374DC05B003D6C014841C0C99BD54ABA374DC05E21646B014841C0950E9900A8374DC0940B7F47F24741C0269EA46DAD374DC0FF388EC0E84741C03ECAA165C0374DC0B080B7FFEA4741C066347045CD374DC01E3A873EED4741C06C1A4F35DE374DC05412783FED4741C060EA5BF3E2374DC090AABA3FED4741C0922EE39FF8374DC050362081EB4741C054761CBBFE374DC010DC2303EB4741C0AD212BDE10384DC08B6F4025E74741C0B494AABC13384DC0D35D1588E64741C095552B5B25384DC042E2345FE04741C04EC8A4C83F384DC0FFF71F2AD54741C0C2E0893E4F384DC09D765E74CC4741C0BD90DFD669384DC04DDCFB74B64741C02355C1597A384DC0A2A14BE0984741C0C27A752B80384DC002093825864741C07039031B7D384DC0E6C6FD527E4741C06D8EAADB74384DC0CB7D7F53684741C047BE4AC65F384DC0F1CD0C15534741C0898FE60447384DC0D0B45C2E464741C07B167C592D384DC021A522D53D4741C06EF8A21704384DC02A63D8A72E4741C07F94C725F5374DC0ADD0D625254741C0EFA32042F4374DC06DA0555A244741C07FC004DEE4374DC05FC6A79B164741C00E758D88E3374DC0F331016A154741C01415FF8CD6374DC086BA7F0D0B4741C06DD6B319CA374DC05D4CA56F034741C0B8FF9939C1374DC00A33F200FE4641C06752F43CB4374DC0FE2E5240F84641C095E43C5999374DC0E2E2E258EC4641C0225897BC91374DC0EB97AC77E74641C00E26FCA0A2374DC072EDE5D9DB4641C042C6552BA2374DC041CAF268D34641C07597458E9A374DC007379BDECA4641C0A7FE5FBE8D374DC0C2345013C34641C035D10D487E374DC039A7DFAAB94641C05AE49E067C374DC048346D5CB84641C076212DCC4A374DC0FDBCB4029D4641C0832627B733374DC0E7B3B0D58E4641C032F821C42C374DC0185534578B4641C0E68D04CF26374DC0BA0746B2894641C0672FAFAB24374DC02968655A894641C0757A086B17374DC029C1AE39874641C02CE835430A374DC0B39860FD854641C0E83C62D400374DC02FCF52C1844641C076D22D74EF364DC02AEA62E7824641C0A2851573DC364DC0171F5B1E8F4641C03B093C43C8364DC06A1FFC9F974641C0","PALERMO",16029.2725961,5331336.47836,22672,10290,12382,14,34
150,"0106000020E6100000010000000103000000010000006F000000B42C690549364DC070EBDB860F4941C0EE405D083C364DC01A37F62C034941C07353364F27364DC081BBCFE9F44841C01B34B44F21364DC02A6AD859EF4841C0B74FF93903364DC0D885B83FCF4841C038183B83F0354DC05CEDF5B3AF4841C0F40AA2C8D7354DC0FE945016854841C0D88160BECA354DC019236FE37D4841C030CC56B9C2354DC0039CFB7F6F4841C06CF62B0CBE354DC01009F232674841C01FB74EB6BC354DC0E9FA3F53634841C0FA112065BB354DC0257DC333644841C03486D71BB7354DC065E69173534841C08A4CD70359354DC0A00C34D5084841C0D28CFCB553354DC057752830074841C088C5C4C14B354DC0C1C7EBD3084841C06071A0CC43354DC0CB8BCF910B4841C0101183F525354DC03B7897A71D4841C0BC15740818354DC09C1CD36B264841C04F22283CF2344DC0E394FD253A4841C09BFD3EC1CF344DC0DE5280224B4841C0619B99CBC7344DC0E7C6399E504841C07403FA049E344DC03922C457644841C01EB0E4DC7C344DC036FFC4F8764841C09B68970261344DC0D0237E50864841C09F0AF6E834344DC0AB2D753B9C4841C02CC4BA5F20344DC05BF864EE874841C0C1716BC515344DC0C10511CC804841C0ED29CFD907344DC0ACB020257F4841C0D873D2EDF9334DC00AB029B07F4841C0AF977F54ED334DC039EBDB11844841C0C0E137D0D0334DC002CDE8F5934841C0A6BEBCEBBC334DC01EF2322D9C4841C0FB5E8855AE334DC0EE84FA759F4841C0B11554199D334DC02C0528E79E4841C0D7215ED88F334DC0E32D68C4974841C073117F348B334DC0B1B83A79944841C08E286C9581334DC0D5CF9CA1A14841C0938AF0AB6F334DC0586BB844B44841C07126D17358334DC024025918C94841C06FB8BFDB49334DC043D75EB3D54841C05C84023437334DC084A065B5E04841C09644B42836334DC060294793E24841C096D2D5CE30334DC01B31233EEC4841C06E2920CB2B334DC00D292406F54841C0B893E2FE28334DC05F80F6D8FB4841C05BF1F13E28334DC0FC67ADD9FD4841C0C816171428334DC01706ADF1044941C0D9F9C59928334DC0086655E2074941C08246F00229334DC012A017F6094941C0AC4F1DF429334DC02E2EF8B70E4941C05B29B0F02B334DC010F37024114941C08D2DA4B22F334DC0438E97C9164941C05582357A3F334DC016A0F897284941C0819D1A8943334DC066FF91512E4941C0508E987D46334DC07813FED2314941C0D608EBC36C334DC0C8AE353F5C4941C0EFA9E10C76334DC06D247B4C694941C0FDD779F076334DC0432C0C346A4941C0C8D55F5E7D334DC059E2B5C1704941C0935BD1138A334DC0982A934F7D4941C071E7DDFB88334DC0AC98AD1E7E4941C0625FAE2482334DC02B96B331864941C0F137702679334DC0D1F454FF904941C02924C6BC78334DC0C3931B7F914941C0A152775569334DC003963F01A44941C0537687B458334DC0D8FDAEBDB14941C01C3217BD48334DC04225C641BC4941C0D4AD04DA43334DC0942F527ABF4941C0127A364031334DC05102F46ACA4941C09E5FED142F334DC07B23EE77CB4941C0D7007AF213334DC06251299DD84941C097AB1EA705334DC0FAC77A44E04941C04283F2BA04334DC01583ABC2E04941C011CE182FEE324DC0EA6DF6A8EF4941C0DA9632ACEB324DC03FBCF350F14941C046E608BACA324DC0C16A020F074A41C089E3D82AC5324DC075AD64BA0A4A41C0EE4CA477C2324DC00CC71B820C4A41C0D942EC97C8324DC06007444B164A41C023B0023DF5324DC07C6ED3C9544A41C0E482AA7B1A334DC017D017BF904A41C0CF872A8C1E334DC07A7A5589964A41C0C5CA1FA81B334DC07986BA21974A41C02FB6D5DF44334DC0A522DCEECF4A41C0D2DEB2F844334DC030E3E610D04A41C04D91B67A5A334DC09DEBBBCEBC4A41C0FAB109B172334DC06E201DBBAD4A41C01CB0B605E3334DC0DA1819A2AE4A41C02E836420FD334DC0E9B0E5D7AE4A41C04E772B41DD334DC075DABE1B714A41C05B914789DB334DC0E62C88BC6D4A41C0F95EBD78CB334DC0E8F1AC2C4E4A41C04D288389F0334DC0081CA92A314A41C015AB9C0718344DC080D1B06E0F4A41C0B3CFDC7531344DC0B2943DB7024A41C039BE44864D344DC07BCF4556F64941C023BC426276344DC00F2D8750E44941C0E4CF32F2B2344DC03C4193ACC84941C0194EAA72E0344DC0877D6D53B54941C01D20B2A314354DC039E15F009D4941C010B1F0A91C354DC035BC4517A34941C08949A15E27354DC087711F1D9E4941C0674208C234354DC02E7C9CD6904941C0B0202C7D45354DC044827F39854941C0475D410A81354DC0C96DC079684941C0F3D13C9EC4354DC0E8EFDE9E4A4941C061B2A2D0FA354DC0B43007BD314941C0EE82C6A82B364DC073F020BA1C4941C027BE3B3141364DC01500CB0B134941C0B42C690549364DC070EBDB860F4941C0","PALERMO",8196.66982808,2687803.20415,13165,6154,7011,14,34
151,"0106000020E6100000010000000103000000010000002B00000039BE44864D344DC07BCF4556F64941C0038B37EC62344DC007561D521A4A41C07D18845988344DC00F37BA28594A41C00A9224CF9E344DC0ABB490A27E4A41C05DBC738BE9344DC07CB93BAFAF4A41C0FA7F8CE83D354DC0757B1C9CE64A41C01B2F1AF563354DC00983A2A3CC4A41C02F39B4CEE4354DC04C3EF8D9734A41C07E588A0603364DC017A3870A5F4A41C0D1E734E837364DC0F2DE46463A4A41C0A6CC9C1651364DC05F03C2D9264A41C0032FF01266364DC0F173CBAB194A41C0BBD8E7776E364DC06B3B4758114A41C066522FF785364DC0E11C74F1064A41C0B871A99B98364DC0EC19F9A5014A41C04229E7D1A0364DC0EFD81151FF4941C008F33095C6364DC050C3FAD5F24941C065778F9ADF364DC02475C327DE4941C02CD15908EE364DC006EB993AD24941C0B0B133751D374DC0ED307F84A64941C0A5019B4938374DC07CE1278A8E4941C0FC3BB5823C374DC0AD9BCBC38A4941C0ED1F80E43D374DC0406DDA7A894941C0992B5FDC07374DC005768685784941C03B47A883F8364DC0430F7D4D734941C07B950669DF364DC082F2F522684941C03BC71CB9B2364DC0C6CABD89524941C097ADCF3B55364DC00C564AD71E4941C0B42C690549364DC070EBDB860F4941C027BE3B3141364DC01500CB0B134941C0EE82C6A82B364DC073F020BA1C4941C061B2A2D0FA354DC0B43007BD314941C0F3D13C9EC4354DC0E8EFDE9E4A4941C0475D410A81354DC0C96DC079684941C0B0202C7D45354DC044827F39854941C0674208C234354DC02E7C9CD6904941C08949A15E27354DC087711F1D9E4941C010B1F0A91C354DC035BC4517A34941C01D20B2A314354DC039E15F009D4941C0194EAA72E0344DC0877D6D53B54941C0E4CF32F2B2344DC03C4193ACC84941C023BC426276344DC00F2D8750E44941C039BE44864D344DC07BCF4556F64941C0","PALERMO",5415.19500033,1597314.30839,24655,11170,13485,14,34
152,"0106000020E610000001000000010300000001000000150000002E836420FD334DC0E9B0E5D7AE4A41C073C9C737FD334DC0EA76E8D7AE4A41C069C738D704344DC0959187EABA4A41C0528DDB9F2D344DC03C954F19F44A41C020ABE32D7D344DC078C6AC92654B41C02770FC2BCB344DC011545299324B41C0EFB59B38FF344DC02DEB8B390F4B41C093B6AE573D354DC063CD24FFE64A41C0FA7F8CE83D354DC0757B1C9CE64A41C05DBC738BE9344DC07CB93BAFAF4A41C00A9224CF9E344DC0ABB490A27E4A41C07D18845988344DC00F37BA28594A41C0038B37EC62344DC007561D521A4A41C039BE44864D344DC07BCF4556F64941C0B3CFDC7531344DC0B2943DB7024A41C015AB9C0718344DC080D1B06E0F4A41C04D288389F0334DC0081CA92A314A41C0F95EBD78CB334DC0E8F1AC2C4E4A41C05B914789DB334DC0E62C88BC6D4A41C04E772B41DD334DC075DABE1B714A41C02E836420FD334DC0E9B0E5D7AE4A41C0","PALERMO",3317.03335749,569756.671871,20270,8887,11383,14,34
153,"0106000020E6100000010000000103000000010000001600000020ABE32D7D344DC078C6AC92654B41C081096BCE7D344DC0AAF92877664B41C0828DBC107E344DC00C131BC5664B41C0CA503C2DC8344DC07AC56EF9BD4B41C066B6A1BD0A354DC0E82ACA320A4C41C0F5A234F740354DC09FD5235FE04B41C0459B6E4561354DC013743531C84B41C004DAE640A2354DC0A3AC4601A04B41C080A849E9CA354DC00E708C33874B41C012C30687F0354DC0C8F01F557A4B41C08E0E2DE513364DC0CA92552F6D4B41C0A10E62D00A364DC06BC2AB30674B41C08287E7A60A364DC01147A411674B41C071838AE5FE354DC085C7DA735E4B41C0E675B0A8F3354DC0CD4131F8574B41C0B68B404A9B354DC06613DF70204B41C0802ACFD63E354DC08D904037E74A41C0FA7F8CE83D354DC0757B1C9CE64A41C093B6AE573D354DC063CD24FFE64A41C0EFB59B38FF344DC02DEB8B390F4B41C02770FC2BCB344DC011545299324B41C020ABE32D7D344DC078C6AC92654B41C0","PALERMO",3047.3951235,538123.036127,24918,10938,13980,14,34
154,"0106000020E61000000100000001030000000100000019000000BE2917F320374DC06B0F6A4D8B4A41C00899C4280B374DC0F62CAD257B4A41C024E2C8AEEA364DC00F2E41715D4A41C09A9CE54CDB364DC0F47D794B4F4A41C0A14CFFE4CA364DC0155212303D4A41C0B871A99B98364DC0EC19F9A5014A41C066522FF785364DC0E11C74F1064A41C0BBD8E7776E364DC06B3B4758114A41C0032FF01266364DC0F173CBAB194A41C0A6CC9C1651364DC05F03C2D9264A41C0D1E734E837364DC0F2DE46463A4A41C07E588A0603364DC017A3870A5F4A41C02F39B4CEE4354DC04C3EF8D9734A41C01B2F1AF563354DC00983A2A3CC4A41C0FA7F8CE83D354DC0757B1C9CE64A41C0802ACFD63E354DC08D904037E74A41C0B68B404A9B354DC06613DF70204B41C0E675B0A8F3354DC0CD4131F8574B41C071838AE5FE354DC085C7DA735E4B41C08287E7A60A364DC01147A411674B41C0ECAF9E8848364DC085272997364B41C06FED54B388364DC0ED6928D0034B41C069A90E0FBC364DC0C258E53ADB4A41C01926392DF6364DC07828A028AD4A41C0BE2917F320374DC06B0F6A4D8B4A41C0","PALERMO",3649.42689756,764059.729388,27373,12362,15011,14,34
155,"0106000020E6100000010000000103000000010000002F0000009744C86018384DC01C7BB7A95F4B41C0AB8F96EB18384DC024677A4D5F4B41C0A215BAF421384DC0F45BE078594B41C03B71A2777F384DC05676B09D1B4B41C0305F0B06EF384DC082CD6D5BD14A41C03D7A9ED7E1384DC0D75FCA32A64A41C01C6352DCE3384DC0A58D935DA54A41C025AF4AA8C2384DC0C43E4FF5774A41C02E36590850384DC0288F195C0D4A41C0B1A31F2370384DC063925A17F54941C057BB3EF08E384DC0C45E058DD34941C096497659B0384DC0192A92F6BC4941C0259D4109D5384DC055CC6B73A54941C0D6036000C7384DC03B20D47D974941C065BE5008C6384DC0C4647486964941C0732D18D5B6384DC0608657429D4941C0091CD0BF9E384DC0A623D2A8A64941C0CB5EF2F87F384DC0283F299DB04941C03625668D66384DC08E971DB2B64941C0121F156D42384DC0B84C41C7BC4941C05EBDDBAD2B384DC0A31C726EBE4941C02398C33A0A384DC0D24DBC6CBE4941C074769E24F0374DC039A868A7BB4941C062D1F4B8D6374DC0B696DD53B84941C05323E892AA374DC0F7D695B2AC4941C03A228B248D374DC011F73964A44941C0989832AF67374DC036B1B0F99A4941C024FADA9145374DC0429A761D924941C0A5019B4938374DC07CE1278A8E4941C0B0B133751D374DC0ED307F84A64941C02CD15908EE364DC006EB993AD24941C065778F9ADF364DC02475C327DE4941C008F33095C6364DC050C3FAD5F24941C04229E7D1A0364DC0EFD81151FF4941C0B871A99B98364DC0EC19F9A5014A41C0A14CFFE4CA364DC0155212303D4A41C09A9CE54CDB364DC0F47D794B4F4A41C024E2C8AEEA364DC00F2E41715D4A41C00899C4280B374DC0F62CAD257B4A41C0BE2917F320374DC06B0F6A4D8B4A41C0B3B0875941374DC0F3DF3C53A34A41C02225D86B79374DC04305905ACC4A41C0EF4EE4CFC4374DC0DAFFCA5F044B41C05D31FCF3E4374DC07BCC9ADB1B4B41C02CF034780D384DC06763EB8F394B41C00DB3181A0C384DC0777BBF423B4B41C09744C86018384DC01C7BB7A95F4B41C0","PALERMO",5562.40871708,1416850.18111,23252,11303,11949,14,34
156,"0106000020E610000001000000010300000001000000170000000CA78BB60B374DC0395A2B12124C41C0525EA67331374DC0C7EBF607FA4B41C002B4E5BE32374DC080CFAB29F94B41C0AD8C957157374DC0D74E4787E04B41C05CB49408B7374DC00FA9345DA04B41C09744C86018384DC01C7BB7A95F4B41C00DB3181A0C384DC0777BBF423B4B41C02CF034780D384DC06763EB8F394B41C05D31FCF3E4374DC07BCC9ADB1B4B41C0EF4EE4CFC4374DC0DAFFCA5F044B41C02225D86B79374DC04305905ACC4A41C0B3B0875941374DC0F3DF3C53A34A41C0BE2917F320374DC06B0F6A4D8B4A41C01926392DF6364DC07828A028AD4A41C069A90E0FBC364DC0C258E53ADB4A41C06FED54B388364DC0ED6928D0034B41C0ECAF9E8848364DC085272997364B41C08287E7A60A364DC01147A411674B41C0A10E62D00A364DC06BC2AB30674B41C08E0E2DE513364DC0CA92552F6D4B41C0552C82E364364DC0A8AF3AA9A24B41C007709D34CA364DC01231CB04E64B41C00CA78BB60B374DC0395A2B12124C41C0","PALERMO",3987.41695057,1005586.93535,11998,5847,6151,14,34
157,"0106000020E6100000010000000103000000010000001A00000066B6A1BD0A354DC0E82ACA320A4C41C0511FBD340B354DC07D16BDBB0A4C41C067FBE3CE2F354DC03249E311614C41C0CF71B0893F354DC0664D8285864C41C0C9C90119A0354DC07DA26273844C41C0A64D4F31C8354DC05B492097834C41C06AC7F1BFFC354DC0643D4476824C41C0EBAA297522364DC0454645CF814C41C013B154C730364DC0B4D4262D834C41C0A0B2A23736364DC05844223E7F4C41C00549BD5861364DC0E7C7C09D6C4C41C0E76612F787364DC0655E71B75D4C41C07FF2B3FBA2364DC00DDA063C524C41C0685E8A29A4364DC0AE1DB595514C41C07B080E8DA8364DC08E28962A4F4C41C07D60A7A0EE364DC027CC8899244C41C00CA78BB60B374DC0395A2B12124C41C007709D34CA364DC01231CB04E64B41C0552C82E364364DC0A8AF3AA9A24B41C08E0E2DE513364DC0CA92552F6D4B41C012C30687F0354DC0C8F01F557A4B41C080A849E9CA354DC00E708C33874B41C004DAE640A2354DC0A3AC4601A04B41C0459B6E4561354DC013743531C84B41C0F5A234F740354DC09FD5235FE04B41C066B6A1BD0A354DC0E82ACA320A4C41C0","PALERMO",3658.93829958,854185.424936,15921,7630,8291,14,34
163,"0106000020E610000001000000010300000001000000BF010000A215BAF421384DC0F45BE078594B41C0450FA86825384DC0A1D1163B5B4B41C0B005805826384DC005A991A95B4B41C09E58524827384DC0242B47175C4B41C01FD9E93828384DC0EC3E00855C4B41C08BECC12829384DC0D673BAF25C4B41C003BC95182A384DC0F3EA6F605D4B41C0544B2D092B384DC09AF328CE5D4B41C08B6D05F92B384DC06C1DE33B5E4B41C04B27DCE82C384DC0908998A95E4B41C04C45B4D82D384DC05D4313185F4B41C0A4E84BC92E384DC0BAB1C8855F4B41C072D51FB92F384DC0139E81F35F4B41C0942237A830384DC02943FC61604B41C052540F9831384DC0A71C78D0604B41C05E62228732384DC0BE2EEF3E614B41C01190FA7633384DC033982BAE614B41C0C2990D6634384DC035F4671D624B41C0FB7F655435384DC062899F8C624B41C09E85784336384DC0E3A39DFC624B41C07E1ECC3137384DC0D925986C634B41C024AE1F2038384DC06DF557DD634B41C0171AB80D39384DC0A989164E644B41C0117D46FB39384DC0A98294BF644B41C025E5DEE83A384DC07CD51431654B41C0F8516DD63B384DC0A75296A2654B41C027C405C43C384DC0389E1614664B41C075BBD4B03D384DC0B5165586664B41C0D572679E3E384DC00F4F98F8664B41C042BD3A8B3F384DC0F64BDA6A674B41C0AB0C0E7840384DC0B9731DDD674B41C03D18DD6441384DC0C9DD5B4F684B41C0DE71B05142384DC0E0CF9DC1684B41C076B0443F43384DC0B9C7DF33694B41C02414182C44384DC011E122A6694B41C0B741E71845384DC0DD769F176A4B41C0C6217A0646384DC0C763E1896A4B41C0E6944DF346384DC0DFE620FC6A4B41C089FAE1E047384DC0C706A16D6B4B41C066F774CE48384DC0765122DF6B4B41C0236709BC49384DC01D6AA2506C4B41C0566E9CA94A384DC0202220C26C4B41C0330870964B384DC0432AA0336D4B41C07C7904844C384DC0E1FDE1A56D4B41C0D98F97714D384DC003AB5F176E4B41C018AB2A5F4E384DC077B1DF886E4B41C0CDC6FF4B4F384DC0B2D960FA6E4B41C021EC923950384DC0E9D8E06B6F4B41C06C84272751384DC09C775EDD6F4B41C0215DB61452384DC03235A04F704B41C0CADA4D0253384DC0345821C1704B41C00C591DEF53384DC030B49D32714B41C06205B2DC54384DC057A11DA4714B41C0ED4845CA55384DC046B99E15724B41C04BFFD9B756384DC0A5CD1F87724B41C0474D6DA557384DC06C249CF8724B41C0B82D419258384DC0F7F91B6A734B41C0DFE5D57F59384DC04DC95EDC734B41C00043696D5A384DC03415DB4D744B41C09B12FE5A5B384DC073175CBF744B41C09A7991485C384DC085E7DB30754B41C04F5326365D384DC083E25CA2754B41C04352FA225E384DC0F016D913764B41C04FC88D105F384DC09D0A5A85764B41C07BB122FE5F384DC0D540D6F6764B41C076E8B1EB60384DC095FE5568774B41C0A7244BD961384DC0A6E7D6D9774B41C0A865DAC662384DC09BCC574B784B41C0873E72B463384DC073F4D3BC784B41C074F702A264384DC0C1A3532E794B41C018DA9A8F65384DC03C7ED49F794B41C05C9D2B7D66384DC0DC9A50117A4B41C0DA40BF6A67384DC0E26DD1827A4B41C08EAD585868384DC03E498FF37A4B41C01F12E84569384DC064890C657B4B41C0D37B81336A384DC055238CD67B4B41C040EA10216B384DC0A4E70C487C4B41C0FFB3A40E6C384DC0B2E2CBB87C4B41C0D1E339FC6C384DC021E6472A7D4B41C0F68A8EEA6D384DC01F7AC79B7D4B41C00CAD26D86E384DC07C6A860C7E4B41C000ECBBC56F384DC00363027E7E4B41C0F2C14FB370384DC0BF1183EF7E4B41C0C40AE5A071384DC0728E02617F4B41C03D2FB58D72384DC097A17FD27F4B41C06714497B73384DC0FC16FF43804B41C0ACF1DC6874384DC00B7D41B6804B41C0B14E725675384DC03FEBC027814B41C098D0464376384DC022F03D99814B41C0E72ADC3077384DC0E91C7F0B824B41C0ECA9B01D78384DC05B3DC07D824B41C0F32D850A79384DC0AA8802F0824B41C0176E55F779384DC047164062834B41C0F36EE9E47A384DC0843481D4834B41C02F02BED17B384DC00075C346844B41C0CA9A92BE7C384DC0FAF700B9844B41C0F9EE62AB7D384DC09702422B854B41C0CD8437987E384DC099CF449E854B41C04D2C0C857F384DC0AA018710864B41C032D9E07180384DC03776C482864B41C0AA41B15E81384DC0677205F5864B41C0B06A69E882384DC0C17FF0B2874B41C04AD439D583384DC0BFACEF25884B41C096980EC284384DC0E99B3098884B41C05155E3AE85384DC0C97B340B894B41C0C091B99B86384DC062D8717D894B41C0BDA1888887384DC04F8274F0894B41C095079E7488384DC09C5AB5628A4B41C07F8F6E6189384DC068FDB7D58A4B41C06372434E8A384DC0017AF6478B4B41C0BE4D183B8B384DC0C615F9BA8B4B41C0A13AED278C384DC01DE8392D8C4B41C0EAD6BD148D384DC07C7C3CA08C4B41C04F5BD3008E384DC048E27A128D4B41C0064BA8ED8E384DC0A36F7D858D4B41C0F20279DA8F384DC06133BEF78D4B41C0D8FC4DC790384DC085B9C06A8E4B41C0540823B491384DC04A19FFDC8E4B41C0690CF8A092384DC0399801508F4B41C0A3D8C88D93384DC08E4D42C28F4B41C068F39D7A94384DC005747F34904B41C0904AAF6695384DC0260E83A7904B41C0416F845396384DC0D7B8C319914B41C03B99594097384DC082D4008C914B41C0D7BB2E2D98384DC0D23D03FF914B41C09062C31A99384DC06B144571924B41C04E099A079A384DC0C0B085E3924B41C0909069F49A384DC0BFBDC255934B41C05B4140E19B384DC0568104C8934B41C08A8915CE9C384DC0C812453A944B41C0CAD6EABA9D384DC0A0A085AC944B41C001537BA89E384DC06EA7C21E954B41C053AA50959F384DC0875C0491954B41C0C7062682A0384DC08ADF4403964B41C08074FB6EA1384DC02E3CC174964B41C0CBBB915CA2384DC02DC001E7964B41C030DE6249A3384DC02D384259974B41C0D2C1F736A4384DC058E383CB974B41C0CF43CD23A5384DC00F03FF3C984B41C0699F6311A6384DC08F783FAF984B41C0411F39FEA6384DC0C7108121994B41C01F670AEBA7384DC07D25FC92994B41C02F649FD8A8384DC012903C059A4B41C01DFF74C5A9384DC0A257BC769A4B41C049740BB3AA384DC09A2FF9E89A4B41C0720DE19FAB384DC0C6B53A5B9B4B41C0A62A768DAC384DC00A4CB9CC9B4B41C002CE4B7AAD384DC0839CF93E9C4B41C03763E267AE384DC0A4CE75B09C4B41C06FC7B354AF384DC0B417B6229D4B41C0CAF84842B0384DC0F6CD35949D4B41C0BADAE32FB1384DC0BE8C72069E4B41C0E459B51CB2384DC02505F1779E4B41C08C1B8B09B3384DC06C6E32EA9E4B41C0AF5520F7B3384DC01C226F5C9F4B41C0210EB7E4B4384DC0D597EDCD9F4B41C000DF8CD1B5384DC043F62E40A04B41C0BB6B5EBEB6384DC071226FB2A04B41C0CFC5F3ABB7384DC0CF01EA23A14B41C0DDA5C998B8384DC069552B96A14B41C0F86B6086B9384DC0D97E6B08A24B41C0FA613673BA384DC0FB79E779A24B41C005080860BB384DC01E9427ECA24B41C0996F9D4DBC384DC0A0B2675EA34B41C0FC68733ABD384DC02AF4A8D0A34B41C0B9674927BE384DC03878E542A44B41C04E6B1F14BF384DC0178425B5A44B41C0A02AF100C0384DC0A7BA6627A54B41C08D1988EEC0384DC0B33BA399A54B41C0592C5EDBC1384DC0BB3CE30BA64B41C0254434C8C2384DC0A568247EA64B41C08AD4C9B5C3384DC0C4DE60F0A64B41C0F601A0A2C4384DC02A0FDF61A74B41C0AEDF718FC5384DC0123020D4A74B41C0D5EC087DC6384DC0D0266046A84B41C0E49C9E6AC7384DC0A0C8DAB7A84B41C06BDE7457C8384DC00B195A29A94B41C0CAFA0B45C9384DC0E9049A9BA94B41C0BAB9A132CA384DC0C155190DAA4B41C0AB0A781FCB384DC06FE1937EAA4B41C073410F0DCC384DC0152B13F0AA4B41C0960FA5FACC384DC091429161AB4B41C0BF503CE8CD384DC011CB0BD3AB4B41C0B01DD2D5CE384DC098CF4C45AC4B41C05F3EA4C2CF384DC073D4CAB6AC4B41C09E8E3BB0D0384DC08C804628AD4B41C00376D19DD1384DC0E885C499AD4B41C06662678BD2384DC01BB6430BAE4B41C0A4C1FE78D3384DC046B4C17CAE4B41C0DF39D565D4384DC09FE1FDEEAE4B41C02AA36C53D5384DC002077D60AF4B41C0BEA30241D6384DC0B728FCD1AF4B41C0252BD92DD7384DC0384B3844B04B41C0AEA3701BD8384DC04337B6B5B04B41C0EE344708D9384DC06F0CF727B14B41C0BB00D9F5D9384DC096657199B14B41C02F9CAFE2DA384DC01305B10BB24B41C019BB45D0DB384DC00A11307DB24B41C0E641DDBDDC384DC0C6B06FEFB24B41C0A4F7B3AADD384DC0A722EB60B34B41C0D41A4A98DE384DC016BB2AD3B34B41C05E3D2285DF384DC092486A45B44B41C0C075B872E0384DC0FEB6E5B6B44B41C063EB8A5FE1384DC0073D2529B54B41C0AD2D214DE2384DC09E2FA49AB54B41C0E8F6F739E3384DC02D23E00CB64B41C022B18F27E4384DC01CE05D7EB64B41C037846614E5384DC056869EF0B64B41C029133901E6384DC052FADD62B74B41C00726D5EEE6384DC0232158D4B74B41C04551A6DBE7384DC050BC9846B84B41C0C6243EC9E8384DC0226716B8B84B41C02C1115B6E9384DC050FB562AB94B41C08076ABA3EA384DC039D9929CB94B41C091E58390EB384DC0EF71100EBA4B41C0C6541A7EEC384DC080025180BA4B41C01917ED6AED384DC05D08CBF1BA4B41C089478958EE384DC06C630A64BB4B41C04D9B5A45EF384DC0B6E14AD6BB4B41C07197F232F0384DC021E4C447BC4B41C06DACC91FF1384DC0EE2C04BABC4B41C069B2610DF2384DC0FFE1822BBD4B41C085D138FAF2384DC09623C29DBD4B41C00C74CFE7F3384DC0EC453D0FBE4B41C00154A2D4F4384DC01F807C81BE4B41C0740039C2F5384DC0A526FBF2BE4B41C07615D1AFF6384DC084D53665BF4B41C06158A89CF7384DC0373FB4D6BF4B41C083093F8AF8384DC0ADA0F448C04B41C048C41777F9384DC0370372BAC04B41C0CF7FAE64FA384DC086A3AD2CC14B41C0918D8151FB384DC0192D2C9EC14B41C0140A1E3FFC384DC0CE516B10C24B41C0B195B02CFD384DC02CDBE981C24B41C0BCF18719FE384DC0FC6525F4C24B41C0CCD01E07FF384DC0C9B9A265C34B41C0C722B7F4FF384DC010AD1DD7C34B41C026988EE100394DC0A3F29A48C44B41C0FA7B25CF01394DC0DA2FDBBAC44B41C0FFDCBDBC02394DC03675582CC54B41C0571891A903394DC0D852D39DC54B41C0F95E2C9704394DC00C91500FC64B41C09C7BC08405394DC02F918F81C64B41C07ACC5B7206394DC0316B0AF3C64B41C0C246F45F07394DC0689E8764C74B41C01F9BC74C08394DC062F505D6C74B41C0BBB15E3A09394DC050218347C84B41C0443BF7270A394DC0B6ECFDB8C84B41C0F75B8E150B394DC05D117B2AC94B41C0A78125030C394DC0E260F99BC94B41C0661ABEF00C394DC0ECF2720DCA4B41C0304A55DE0D394DC02B3BF17ECA4B41C0F1782ECB0E394DC0914A6EF0CA4B41C0D4B2C5B80F394DC0938BEC61CB4B41C0FFF15CA610394DC00E0F66D3CB4B41C0BDA3F59311394DC0DB48E444CC4B41C002ED8C8112394DC013C55DB6CC4B41C0E8A8256F13394DC025C9DA27CD4B41C007FCBC5C14394DC000F85899CD4B41C006C2554A15394DC0CFF4D50ACE4B41C06D1FED3716394DC0FE90507CCE4B41C087EF852517394DC08B86CDEDCE4B41C0DA561D1318394DC0E4A64B5FCF4B41C03831B60019394DC0C309C5D0CF4B41C0A32E8EED19394DC02E1C4342D04B41C0E15B21DB1A394DC00703C0B3D04B41C06F8EBEC81B394DC011153E25D14B41C0F4C551B61C394DC03C69B796D14B41C08F4BE9A31D394DC0D2733508D24B41C00B4482911E394DC05A4CB279D24B41C0FED3197F1F394DC0C6952BEBD24B41C082D6B26C20394DC08795A95CD34B41C096F28A5921394DC05A22E8CED34B41C09F91224722394DC0628F6240D44B41C05CA3BB3423394DC0C755DFB1D44B41C0534C532224394DC0F8465D23D54B41C02868EC0F25394DC01C06DA94D54B41C0B69DC4FC25394DC070F51407D64B41C0D4555CEA26394DC0C1DB9278D64B41C0C280F5D727394DC07DBE10EAD64B41C016CFCDC428394DC02ADD895BD74B41C08A4361B229394DC0CC4FC8CDD74B41C0EBC6FE9F2A394DC0CD27463FD84B41C089D1D28C2B394DC04E0181B1D84B41C009A86A7A2C394DC066A3FD22D94B41C0CFED63A22C394DC0B44CEB35D94B41C0D70543672D394DC0B62F3D95D94B41C03454DC542E394DC09BCAB906DA4B41C04DBCB4412F394DC046C4F578DA4B41C002A74C2F30394DC0DF5772EADA4B41C0D7CF201C31394DC01FA7B05CDB4B41C0C3C4B80932394DC089D62ACEDB4B41C0FD2252F732394DC019256940DC4B41C0A0AD2AE433394DC054D2E6B1DC4B41C0FC15C4D134394DC0A6192524DD4B41C0F4AA9CBE35394DC0C1059E95DD4B41C0A1AF34AC36394DC04374DD07DE4B41C03A05099937394DC06CE45979DE4B41C018CBA68638394DC0DF4B99EBDE4B41C0F62A7B7339394DC06229125DDF4B41C0F94313613A394DC0EC5A50CFDF4B41C0716BAB4E3B394DC01666CA40E04B41C01588853B3C394DC0278A08B3E04B41C07AB91D293D394DC080198624E14B41C0FFEFB5163E394DC0B8760296E14B41C0FB1B90033F394DC08C043D08E24B41C08C5C28F13F394DC00089BA79E24B41C0FB0FC2DE40394DC064DB36EBE24B41C06B2F95CB41394DC0CFC6B05CE34B41C0D2E32EB942394DC0C5D7EECEE34B41C09738C7A643394DC0B64D6C40E44B41C03900619444394DC09D91E8B1E44B41C0515FF98145394DC06A466123E54B41C0FF30936F46394DC083B1DE94E54B41C094256C5C47394DC0D8125C06E64B41C0F975C54A48394DC0E8C2D477E64B41C00DF25D3849394DC0475D90E8E64B41C0F6D7F7254A394DC0648B0C5AE74B41C01C5590134B394DC050E489CBE74B41C086D728014C394DC0B57F023DE84B41C079D5C2EE4C394DC09A0BBEADE84B41C0D0615BDC4D394DC0282B3A1FE94B41C0F969F5C94E394DC06124F28FE94B41C09CE24EB84F394DC0BA426E01EA4B41C0097EE7A550394DC0DD85EB72EA4B41C05695819351394DC0B345A2E3EA4B41C0D53A1A8152394DC093811F55EB4B41C043EEB26E53394DC08AC5D9C5EB4B41C0C30B4D5C54394DC0C86E5337EC4B41C083ABA64A55394DC078B10DA8EC4B41C07CAE433856394DC0F2DE8A19ED4B41C0AD91D92557394DC09208088BED4B41C0655E721358394DC0F6AEBEFBED4B41C0F629452859394DC0D5D7627FEE4B41C0993310DE59394DC0CB1CBFC5EE4B41C0E37FE9CA5A394DC0848FBE38EF4B41C05F13FFB65B394DC01B27BFABEF4B41C0838717A35C394DC0BA8CBE1EF04B41C05191EC8F5D394DC0E52E7C92F04B41C06C7D067C5E394DC0618D7B05F14B41C09D6E20685F394DC046E87A78F14B41C05990F55460394DC0D8B976EBF14B41C0F31D0E4161394DC0870D765EF24B41C08ECC232D62394DC0542337D2F24B41C0B046FD1963394DC022A43745F34B41C06B9A110664394DC07E6133B8F34B41C025AA2BF264394DC0DCA6322BF44B41C0212B05DF65394DC030B4F39EF44B41C0E6FB1ACB66394DC0D666EF11F54B41C0E81A35B767394DC072A1EE84F54B41C07F7F49A368394DC0179EAFF8F54B41C0615F5F8F69394DC069D1AE6BF64B41C01AFA387C6A394DC051416CDFF64B41C0B9BF51686B394DC08A6D6B52F74B41C084A667546C394DC0E35B2CC6F74B41C00AE481406D394DC076AF2C39F84B41C0C66F962C6E394DC05D4528ACF84B41C033AFB0186F394DC01629E91FF94B41C07827860570394DC0E948E892F94B41C04471A0F170394DC0099AA506FA4B41C03A11B5DD71394DC005ADA479FA4B41C01765CFC972394DC0668265EDFA4B41C03E0FE4B573394DC0378E6460FB4B41C0786DFEA174394DC000D121D4FB4B41C0E0D8188E75394DC0D4D52047FC4B41C0AA6CEE7A76394DC045A2E1BAFC4B41C07174076777394DC056CEE12DFD4B41C0DC9D1D5378394DC02CD49DA1FD4B41C0991D383F79394DC01FF99D14FE4B41C043E34C2B7A394DC0A5B15E88FE4B41C0142463177B394DC067155AFBFE4B41C0453D7C037C394DC0E0C61A6FFF4B41C05CC996EF7C394DC0CF74DBE2FF4B41C03F11ADDB7D394DC00A1F9C56004C41C0F039C6C77E394DC0553A59CA004C41C030171DB37F394DC0FAD7193E014C41C0AA00329F80394DC06A77DAB1014C41C077A64C8B81394DC003889725024C41C04D1DA27682394DC0B5E0199A024C41C035CDBC6283394DC09275DA0D034C41C028CBD14E84394DC0B0069B81034C41C0FE3BE83A85394DC043945BF5034C41C08695012786394DC01CCD5668044C41C09410181387394DC0855317DC044C41C0EBE132FF87394DC0A910164F054C41C091F947EB88394DC06F04D3C2054C41C00E4A22D889394DC0B2BFD135064C41C07E323DC48A394DC048AC0EA8064C41C0D04313B18B394DC0B28E0E1B074C41C083ABED9D8C394DC0EFED478D074C41C0238D878B8D394DC03EDA84FF074C41C04FE922798E394DC0A02B0171084C41C0AFE4BC668F394DC0A6F9B6E1084C41C067CF175590394DC064BDAF51094C41C039EB374491394DC0D982A8C1094C41C07D64523392394DC0732D1A300A4C41C00407322393394DC0F22A519F0A4C41C01150101394394DC01A99040D0B4C41C0A5C2EB0295394DC00E78B47A0B4C41C0F6FF8AF395394DC0AD4CA7E70B4C41C0D2492AE496394DC05029D7530C4C41C07E414ED697394DC0DFE942BF0C4C41C0E02F33C998394DC0A6AB2E290D4C41C0E9AED7BC99394DC065C0D2900D4C41C0CE2BFBB19A394DC055DBF6F60D4C41C099E8E3A79B394DC00D6C975B0E4C41C027204D9F9C394DC071602DBD0E4C41C046E075979D394DC0D8F8401D0F4C41C0EF5423919E394DC0D2C5D57B0F4C41C0F2BF918B9F394DC0D87CE3D80F4C41C07DFCC386A0394DC0D0347134104C41C093FBF181A1394DC06697398F104C41C02CCCE37DA2394DC0716F7EE8104C41C05E7C967AA3394DC021C88942114C41C087CA8976A4394DC041D20C9B114C41C03C243B73A5394DC0B70B91F3114C41C07DE1AE70A6394DC07EBA914A124C41C0453C216EA7394DC0BD2AD4A0124C41C04E4B186DA8394DC0D8898FF5124C41C08F230B6CA9394DC08C87C848134C41C0E3B6826CAA394DC00EC5BF99134C41C05E8DB064AB394DC04C6BB4EA134C41C0AE6C8E29AC394DC05E9A4DA6144C41C0BD013FA6C7394DC0F794DDB2284C41C04E61BC80CE394DC0753C7C722D4C41C056B33314143A4DC0ACA9A6A55D4C41C01C4DBF684C3A4DC0EAA9296B854C41C0ED96081D4D3A4DC0685300EB854C41C0768971CA653A4DC01ADC8AA27D4C41C0351FD3A09D3A4DC0E88F3D7D6A4C41C0F92F7943A23A4DC04DECF2A1694C41C0AC082828C83A4DC04A29C93A604C41C07CFC0133943A4DC055E20CAD2D4C41C0D9902652553A4DC09926EF7FF24B41C0E840C0840A3A4DC084B2A98FAC4B41C0B43E4CE5CE394DC0589586F7744B41C0C9F6618BB0394DC0207DF72A594B41C0766CD935AC394DC03E2F4CA6434B41C0567096887C394DC0D7F7BC7FB14A41C04BA4C26467394DC06CEFCAEC6C4A41C0E98851EB66394DC07C31EB1A6D4A41C03494BC7E3A394DC02D84ACDE7F4A41C01C6352DCE3384DC0A58D935DA54A41C03D7A9ED7E1384DC0D75FCA32A64A41C0305F0B06EF384DC082CD6D5BD14A41C03B71A2777F384DC05676B09D1B4B41C0A215BAF421384DC0F45BE078594B41C0","CHACARITA",5552.51934428,1166537.28831,12324,6136,6188,15,1
164,"0106000020E6100000010000000103000000010000002B000000AC082828C83A4DC04A29C93A604C41C086F65F79C93A4DC07BD7D3E65F4C41C020FBBE05603B4DC0FB9EAFE1574C41C0CF788145783B4DC0DFEF4E7C594C41C0ECECE4BE8F3B4DC089EA01D15D4C41C02A1565CA943B4DC08968D4F95D4C41C049A8BE0E993B4DC0E5323B62604C41C04F5C1526963B4DC0A7B82F50554C41C0F62FF372723B4DC014F2BD79DD4B41C0157B59B4703B4DC00F6755FBD84B41C034BBB97A713B4DC086035B18D64B41C0615CB615863B4DC0DA65FD6AC44B41C0F672C360A43B4DC05DD9DCA5AA4B41C0C27F40D7A93B4DC0DFA2CC27A74B41C0E34B4515B93B4DC03B8A191F9D4B41C0991EC6A7BB3B4DC04AFF73AC9B4B41C00E527717C13B4DC041E30F9C984B41C0FD0C65D3753B4DC04AEF936A514B41C0B88B4606463B4DC01D0C39F1244B41C01A02D343213B4DC0523B8AB9054B41C06E5428901E3B4DC0DCC9D76D034B41C076CDD33E113B4DC0F7C45195FC4A41C0507CBB04EE3A4DC0D9A64FA6F24A41C0100B56F4EF3A4DC0B19E3193EA4A41C02E2E4F3CEF3A4DC0EE94C016E94A41C054E0F129F03A4DC03467CF12E34A41C0FEB5BAECF23A4DC007A1A044DF4A41C074158277F23A4DC0E393CC2E9E4A41C031A5706CF23A4DC0C960287E054A41C0D97A31CDE83A4DC0B571B4A7054A41C0D65455AE983A4DC0B69040070A4A41C060F277DF383A4DC0957A4D8A244A41C0D28E6BB0FC394DC04267A807384A41C0810F155CB9394DC0496014D44D4A41C04BA4C26467394DC06CEFCAEC6C4A41C0567096887C394DC0D7F7BC7FB14A41C0766CD935AC394DC03E2F4CA6434B41C0C9F6618BB0394DC0207DF72A594B41C0B43E4CE5CE394DC0589586F7744B41C0E840C0840A3A4DC084B2A98FAC4B41C0D9902652553A4DC09926EF7FF24B41C07CFC0133943A4DC055E20CAD2D4C41C0AC082828C83A4DC04A29C93A604C41C0","CHACARITA",6194.60805713,1951553.0723,10840,5296,5544,15,1
162,"0106000020E61000000100000001030000000100000034000000B7A618C3433C4DC008C29889314B41C017EA14AD0E3C4DC080872EF35B4B41C0D2ACB2CAED3B4DC02E22621C764B41C0E04C4085D43B4DC0181D34018A4B41C09C16B861C53B4DC040C0FCEA954B41C00E527717C13B4DC041E30F9C984B41C0991EC6A7BB3B4DC04AFF73AC9B4B41C0E34B4515B93B4DC03B8A191F9D4B41C0C27F40D7A93B4DC0DFA2CC27A74B41C0F672C360A43B4DC05DD9DCA5AA4B41C0615CB615863B4DC0DA65FD6AC44B41C034BBB97A713B4DC086035B18D64B41C0157B59B4703B4DC00F6755FBD84B41C0F62FF372723B4DC014F2BD79DD4B41C04F5C1526963B4DC0A7B82F50554C41C049A8BE0E993B4DC0E5323B62604C41C02A1565CA943B4DC08968D4F95D4C41C0ECECE4BE8F3B4DC089EA01D15D4C41C0CF788145783B4DC0DFEF4E7C594C41C020FBBE05603B4DC0FB9EAFE1574C41C086F65F79C93A4DC07BD7D3E65F4C41C0AC082828C83A4DC04A29C93A604C41C0F92F7943A23A4DC04DECF2A1694C41C0351FD3A09D3A4DC0E88F3D7D6A4C41C0768971CA653A4DC01ADC8AA27D4C41C0E6A2C5E2A43A4DC05E48CB0B4A4D41C0A52C1243BE3A4DC0696495155C4D41C01231771B703B4DC05EBC98F12E4D41C02155A67CD13B4DC0145FBB8B164D41C0808CE839053C4DC0775A19DC094D41C01A9032A41C3C4DC0F91C92E41B4D41C0808D2DBA2F3C4DC0A2D50907294D41C0EA662B79363C4DC08981A39B2C4D41C046691994373C4DC0E390A9522D4D41C08D21DF11613C4DC044D1A6194C4D41C0BBB21945AC3C4DC0168301AC7A4D41C05AB74188AC3C4DC05F88D8D47A4D41C02815AC0BFA3C4DC087BD3C571A4D41C09CEC36730D3D4DC089264EB8004D41C00C3345B91E3D4DC01E7FBCD5E74C41C0BAA035B5FB3C4DC0E3CCA6E7D34C41C0441FD1C9FA3C4DC037D8CD61D34C41C0A05E075D4A3D4DC05FEBBA22C24C41C0148BBC533A3D4DC05CB8F069964C41C00C7C3B2C123D4DC0E0EF92BE2C4C41C0414CB07DEC3C4DC0F7346D2FC44B41C0D748A69EE93C4DC088125B38BC4B41C0EF6536B9E43C4DC042F894D3AF4B41C05ED10705673C4DC0E283B5FF4D4B41C0CFF2808F523C4DC0EF14840C3E4B41C08A897081513C4DC02FA883393D4B41C0B7A618C3433C4DC008C29889314B41C0","PATERNAL",7083.63914393,2229856.74893,17116,8558,8558,15,2
158,"0106000020E6100000010000000103000000010000002200000013B154C730364DC0B4D4262D834C41C037607C803D364DC019B3E398854C41C05375285B91364DC06E260A60874C41C0BA3A40AF95364DC0388A2534884C41C0C9B121FB99364DC0FFA18759884C41C08E7A566DA1364DC079FA21A6894C41C08A6E4F1DC4364DC067D0671C974C41C0B1B801D6EE364DC0CADE9192AA4C41C0D4F49B75F7364DC07D0657C3AF4C41C0B38A717C13374DC0C0D8A80CC94C41C0F13D8D4314374DC0B2D4DBB3C94C41C0107DC2A051374DC056AE8311104D41C064E9B4C551374DC04D70203B104D41C04727AC9FBC374DC06614CB8DEC4C41C078FF8B3B2B384DC0F29F10B7C84C41C0478F4AE266384DC0B037E73D904C41C0A70608AE67384DC0455E18808F4C41C0E333BCF262384DC07031B4958B4C41C0AE0A42AC3C384DC06658058C724C41C0780BB707F9374DC0896570D6474C41C0631A6FEFB0374DC0E8B42271194C41C008BA15728C374DC002973624014C41C0AD8C957157374DC0D74E4787E04B41C002B4E5BE32374DC080CFAB29F94B41C0525EA67331374DC0C7EBF607FA4B41C00CA78BB60B374DC0395A2B12124C41C07D60A7A0EE364DC027CC8899244C41C07B080E8DA8364DC08E28962A4F4C41C0685E8A29A4364DC0AE1DB595514C41C07FF2B3FBA2364DC00DDA063C524C41C0E76612F787364DC0655E71B75D4C41C00549BD5861364DC0E7C7C09D6C4C41C0A0B2A23736364DC05844223E7F4C41C013B154C730364DC0B4D4262D834C41C0","VILLA CRESPO",3878.31856457,742959.552382,19488,9140,10348,15,3
159,"0106000020E6100000010000000103000000010000002C010000A70608AE67384DC0455E18808F4C41C03D819FF09A384DC0C9D80BD55F4C41C0C1CD1FD3CC384DC001DDBB1D324C41C0E5FB988AFC384DC05C57B015074C41C0CFED63A22C394DC0B44CEB35D94B41C009A86A7A2C394DC066A3FD22D94B41C089D1D28C2B394DC04E0181B1D84B41C0EBC6FE9F2A394DC0CD27463FD84B41C08A4361B229394DC0CC4FC8CDD74B41C016CFCDC428394DC02ADD895BD74B41C0C280F5D727394DC07DBE10EAD64B41C0D4555CEA26394DC0C1DB9278D64B41C0B69DC4FC25394DC070F51407D64B41C02868EC0F25394DC01C06DA94D54B41C0534C532224394DC0F8465D23D54B41C05CA3BB3423394DC0C755DFB1D44B41C09F91224722394DC0628F6240D44B41C096F28A5921394DC05A22E8CED34B41C082D6B26C20394DC08795A95CD34B41C0FED3197F1F394DC0C6952BEBD24B41C00B4482911E394DC05A4CB279D24B41C08F4BE9A31D394DC0D2733508D24B41C0F4C551B61C394DC03C69B796D14B41C06F8EBEC81B394DC011153E25D14B41C0E15B21DB1A394DC00703C0B3D04B41C0A32E8EED19394DC02E1C4342D04B41C03831B60019394DC0C309C5D0CF4B41C0DA561D1318394DC0E4A64B5FCF4B41C087EF852517394DC08B86CDEDCE4B41C06D1FED3716394DC0FE90507CCE4B41C006C2554A15394DC0CFF4D50ACE4B41C007FCBC5C14394DC000F85899CD4B41C0E8A8256F13394DC025C9DA27CD4B41C002ED8C8112394DC013C55DB6CC4B41C0BDA3F59311394DC0DB48E444CC4B41C0FFF15CA610394DC00E0F66D3CB4B41C0D4B2C5B80F394DC0938BEC61CB4B41C0F1782ECB0E394DC0914A6EF0CA4B41C0304A55DE0D394DC02B3BF17ECA4B41C0661ABEF00C394DC0ECF2720DCA4B41C0A78125030C394DC0E260F99BC94B41C0F75B8E150B394DC05D117B2AC94B41C0443BF7270A394DC0B6ECFDB8C84B41C0BBB15E3A09394DC050218347C84B41C01F9BC74C08394DC062F505D6C74B41C0C246F45F07394DC0689E8764C74B41C07ACC5B7206394DC0316B0AF3C64B41C09C7BC08405394DC02F918F81C64B41C0F95E2C9704394DC00C91500FC64B41C0571891A903394DC0D852D39DC54B41C0FFDCBDBC02394DC03675582CC54B41C0FA7B25CF01394DC0DA2FDBBAC44B41C026988EE100394DC0A3F29A48C44B41C0C722B7F4FF384DC010AD1DD7C34B41C0CCD01E07FF384DC0C9B9A265C34B41C0BCF18719FE384DC0FC6525F4C24B41C0B195B02CFD384DC02CDBE981C24B41C0140A1E3FFC384DC0CE516B10C24B41C0918D8151FB384DC0192D2C9EC14B41C0CF7FAE64FA384DC086A3AD2CC14B41C048C41777F9384DC0370372BAC04B41C083093F8AF8384DC0ADA0F448C04B41C06158A89CF7384DC0373FB4D6BF4B41C07615D1AFF6384DC084D53665BF4B41C0740039C2F5384DC0A526FBF2BE4B41C00154A2D4F4384DC01F807C81BE4B41C00C74CFE7F3384DC0EC453D0FBE4B41C085D138FAF2384DC09623C29DBD4B41C069B2610DF2384DC0FFE1822BBD4B41C06DACC91FF1384DC0EE2C04BABC4B41C07197F232F0384DC021E4C447BC4B41C04D9B5A45EF384DC0B6E14AD6BB4B41C089478958EE384DC06C630A64BB4B41C01917ED6AED384DC05D08CBF1BA4B41C0C6541A7EEC384DC080025180BA4B41C091E58390EB384DC0EF71100EBA4B41C08076ABA3EA384DC039D9929CB94B41C02C1115B6E9384DC050FB562AB94B41C0C6243EC9E8384DC0226716B8B84B41C04551A6DBE7384DC050BC9846B84B41C00726D5EEE6384DC0232158D4B74B41C029133901E6384DC052FADD62B74B41C037846614E5384DC056869EF0B64B41C022B18F27E4384DC01CE05D7EB64B41C0E8F6F739E3384DC02D23E00CB64B41C0AD2D214DE2384DC09E2FA49AB54B41C063EB8A5FE1384DC0073D2529B54B41C0C075B872E0384DC0FEB6E5B6B44B41C05E3D2285DF384DC092486A45B44B41C0D41A4A98DE384DC016BB2AD3B34B41C0A4F7B3AADD384DC0A722EB60B34B41C0E641DDBDDC384DC0C6B06FEFB24B41C019BB45D0DB384DC00A11307DB24B41C02F9CAFE2DA384DC01305B10BB24B41C0BB00D9F5D9384DC096657199B14B41C0EE344708D9384DC06F0CF727B14B41C0AEA3701BD8384DC04337B6B5B04B41C0252BD92DD7384DC0384B3844B04B41C0BEA30241D6384DC0B728FCD1AF4B41C02AA36C53D5384DC002077D60AF4B41C0DF39D565D4384DC09FE1FDEEAE4B41C0A4C1FE78D3384DC046B4C17CAE4B41C06662678BD2384DC01BB6430BAE4B41C00376D19DD1384DC0E885C499AD4B41C09E8E3BB0D0384DC08C804628AD4B41C05F3EA4C2CF384DC073D4CAB6AC4B41C0B01DD2D5CE384DC098CF4C45AC4B41C0BF503CE8CD384DC011CB0BD3AB4B41C0960FA5FACC384DC091429161AB4B41C073410F0DCC384DC0152B13F0AA4B41C0AB0A781FCB384DC06FE1937EAA4B41C0BAB9A132CA384DC0C155190DAA4B41C0CAFA0B45C9384DC0E9049A9BA94B41C06BDE7457C8384DC00B195A29A94B41C0E49C9E6AC7384DC0A0C8DAB7A84B41C0D5EC087DC6384DC0D0266046A84B41C0AEDF718FC5384DC0123020D4A74B41C0F601A0A2C4384DC02A0FDF61A74B41C08AD4C9B5C3384DC0C4DE60F0A64B41C0254434C8C2384DC0A568247EA64B41C0592C5EDBC1384DC0BB3CE30BA64B41C08D1988EEC0384DC0B33BA399A54B41C0A02AF100C0384DC0A7BA6627A54B41C04E6B1F14BF384DC0178425B5A44B41C0B9674927BE384DC03878E542A44B41C0FC68733ABD384DC02AF4A8D0A34B41C0996F9D4DBC384DC0A0B2675EA34B41C005080860BB384DC01E9427ECA24B41C0FA613673BA384DC0FB79E779A24B41C0F86B6086B9384DC0D97E6B08A24B41C0DDA5C998B8384DC069552B96A14B41C0CFC5F3ABB7384DC0CF01EA23A14B41C0BB6B5EBEB6384DC071226FB2A04B41C000DF8CD1B5384DC043F62E40A04B41C0210EB7E4B4384DC0D597EDCD9F4B41C0AF5520F7B3384DC01C226F5C9F4B41C08C1B8B09B3384DC06C6E32EA9E4B41C0E459B51CB2384DC02505F1779E4B41C0BADAE32FB1384DC0BE8C72069E4B41C0CAF84842B0384DC0F6CD35949D4B41C06FC7B354AF384DC0B417B6229D4B41C03763E267AE384DC0A4CE75B09C4B41C002CE4B7AAD384DC0839CF93E9C4B41C0A62A768DAC384DC00A4CB9CC9B4B41C0720DE19FAB384DC0C6B53A5B9B4B41C049740BB3AA384DC09A2FF9E89A4B41C01DFF74C5A9384DC0A257BC769A4B41C02F649FD8A8384DC012903C059A4B41C01F670AEBA7384DC07D25FC92994B41C0411F39FEA6384DC0C7108121994B41C0699F6311A6384DC08F783FAF984B41C0CF43CD23A5384DC00F03FF3C984B41C0D2C1F736A4384DC058E383CB974B41C030DE6249A3384DC02D384259974B41C0CBBB915CA2384DC02DC001E7964B41C08074FB6EA1384DC02E3CC174964B41C0C7062682A0384DC08ADF4403964B41C053AA50959F384DC0875C0491954B41C001537BA89E384DC06EA7C21E954B41C0CAD6EABA9D384DC0A0A085AC944B41C08A8915CE9C384DC0C812453A944B41C05B4140E19B384DC0568104C8934B41C0909069F49A384DC0BFBDC255934B41C04E099A079A384DC0C0B085E3924B41C09062C31A99384DC06B144571924B41C0D7BB2E2D98384DC0D23D03FF914B41C03B99594097384DC082D4008C914B41C0416F845396384DC0D7B8C319914B41C0904AAF6695384DC0260E83A7904B41C068F39D7A94384DC005747F34904B41C0A3D8C88D93384DC08E4D42C28F4B41C0690CF8A092384DC0399801508F4B41C0540823B491384DC04A19FFDC8E4B41C0D8FC4DC790384DC085B9C06A8E4B41C0F20279DA8F384DC06133BEF78D4B41C0064BA8ED8E384DC0A36F7D858D4B41C04F5BD3008E384DC048E27A128D4B41C0EAD6BD148D384DC07C7C3CA08C4B41C0A13AED278C384DC01DE8392D8C4B41C0BE4D183B8B384DC0C615F9BA8B4B41C06372434E8A384DC0017AF6478B4B41C07F8F6E6189384DC068FDB7D58A4B41C095079E7488384DC09C5AB5628A4B41C0BDA1888887384DC04F8274F0894B41C0C091B99B86384DC062D8717D894B41C05155E3AE85384DC0C97B340B894B41C096980EC284384DC0E99B3098884B41C04AD439D583384DC0BFACEF25884B41C0B06A69E882384DC0C17FF0B2874B41C0AA41B15E81384DC0677205F5864B41C032D9E07180384DC03776C482864B41C04D2C0C857F384DC0AA018710864B41C0CD8437987E384DC099CF449E854B41C0F9EE62AB7D384DC09702422B854B41C0CA9A92BE7C384DC0FAF700B9844B41C02F02BED17B384DC00075C346844B41C0F36EE9E47A384DC0843481D4834B41C0176E55F779384DC047164062834B41C0F32D850A79384DC0AA8802F0824B41C0ECA9B01D78384DC05B3DC07D824B41C0E72ADC3077384DC0E91C7F0B824B41C098D0464376384DC022F03D99814B41C0B14E725675384DC03FEBC027814B41C0ACF1DC6874384DC00B7D41B6804B41C06714497B73384DC0FC16FF43804B41C03D2FB58D72384DC097A17FD27F4B41C0C40AE5A071384DC0728E02617F4B41C0F2C14FB370384DC0BF1183EF7E4B41C000ECBBC56F384DC00363027E7E4B41C00CAD26D86E384DC07C6A860C7E4B41C0F68A8EEA6D384DC01F7AC79B7D4B41C0D1E339FC6C384DC021E6472A7D4B41C0FFB3A40E6C384DC0B2E2CBB87C4B41C040EA10216B384DC0A4E70C487C4B41C0D37B81336A384DC055238CD67B4B41C01F12E84569384DC064890C657B4B41C08EAD585868384DC03E498FF37A4B41C0DA40BF6A67384DC0E26DD1827A4B41C05C9D2B7D66384DC0DC9A50117A4B41C018DA9A8F65384DC03C7ED49F794B41C074F702A264384DC0C1A3532E794B41C0873E72B463384DC073F4D3BC784B41C0A865DAC662384DC09BCC574B784B41C0A7244BD961384DC0A6E7D6D9774B41C076E8B1EB60384DC095FE5568774B41C07BB122FE5F384DC0D540D6F6764B41C04FC88D105F384DC09D0A5A85764B41C04352FA225E384DC0F016D913764B41C04F5326365D384DC083E25CA2754B41C09A7991485C384DC085E7DB30754B41C09B12FE5A5B384DC073175CBF744B41C00043696D5A384DC03415DB4D744B41C0DFE5D57F59384DC04DC95EDC734B41C0B82D419258384DC0F7F91B6A734B41C0474D6DA557384DC06C249CF8724B41C04BFFD9B756384DC0A5CD1F87724B41C0ED4845CA55384DC046B99E15724B41C06205B2DC54384DC057A11DA4714B41C00C591DEF53384DC030B49D32714B41C0CADA4D0253384DC0345821C1704B41C0215DB61452384DC03235A04F704B41C06C84272751384DC09C775EDD6F4B41C021EC923950384DC0E9D8E06B6F4B41C0CDC6FF4B4F384DC0B2D960FA6E4B41C018AB2A5F4E384DC077B1DF886E4B41C0D98F97714D384DC003AB5F176E4B41C07C7904844C384DC0E1FDE1A56D4B41C0330870964B384DC0432AA0336D4B41C0566E9CA94A384DC0202220C26C4B41C0236709BC49384DC01D6AA2506C4B41C066F774CE48384DC0765122DF6B4B41C089FAE1E047384DC0C706A16D6B4B41C0E6944DF346384DC0DFE620FC6A4B41C0C6217A0646384DC0C763E1896A4B41C0B741E71845384DC0DD769F176A4B41C02414182C44384DC011E122A6694B41C076B0443F43384DC0B9C7DF33694B41C0DE71B05142384DC0E0CF9DC1684B41C03D18DD6441384DC0C9DD5B4F684B41C0AB0C0E7840384DC0B9731DDD674B41C042BD3A8B3F384DC0F64BDA6A674B41C0D572679E3E384DC00F4F98F8664B41C075BBD4B03D384DC0B5165586664B41C027C405C43C384DC0389E1614664B41C0F8516DD63B384DC0A75296A2654B41C025E5DEE83A384DC07CD51431654B41C0117D46FB39384DC0A98294BF644B41C0171AB80D39384DC0A989164E644B41C024AE1F2038384DC06DF557DD634B41C07E1ECC3137384DC0D925986C634B41C09E85784336384DC0E3A39DFC624B41C0FB7F655435384DC062899F8C624B41C0C2990D6634384DC035F4671D624B41C01190FA7633384DC033982BAE614B41C05E62228732384DC0BE2EEF3E614B41C052540F9831384DC0A71C78D0604B41C0942237A830384DC02943FC61604B41C072D51FB92F384DC0139E81F35F4B41C0A4E84BC92E384DC0BAB1C8855F4B41C04C45B4D82D384DC05D4313185F4B41C04B27DCE82C384DC0908998A95E4B41C08B6D05F92B384DC06C1DE33B5E4B41C0544B2D092B384DC09AF328CE5D4B41C003BC95182A384DC0F3EA6F605D4B41C08BECC12829384DC0D673BAF25C4B41C01FD9E93828384DC0EC3E00855C4B41C09E58524827384DC0242B47175C4B41C0B005805826384DC005A991A95B4B41C0450FA86825384DC0A1D1163B5B4B41C0A215BAF421384DC0F45BE078594B41C0AB8F96EB18384DC024677A4D5F4B41C09744C86018384DC01C7BB7A95F4B41C05CB49408B7374DC00FA9345DA04B41C0AD8C957157374DC0D74E4787E04B41C008BA15728C374DC002973624014C41C0631A6FEFB0374DC0E8B42271194C41C0780BB707F9374DC0896570D6474C41C0AE0A42AC3C384DC06658058C724C41C0E333BCF262384DC07031B4958B4C41C0A70608AE67384DC0455E18808F4C41C0","VILLA CRESPO",3384.28765896,690945.495524,12238,5857,6381,15,3
160,"0106000020E610000001000000010300000001000000A800000064E9B4C551374DC04D70203B104D41C0009537BE53374DC055ED9C7E124D41C026E8389C77374DC0DC4F517E244D41C0FC311C0CB3374DC08486FA30424D41C0D4AEB843B9374DC059500469454D41C01559BD26F5374DC055BDECD0614D41C07106123D05384DC0849349DA5A4D41C03651E7C525384DC0F3F4D0D2494D41C0538373D04C384DC09F9093CB384D41C0A6BEF8A397384DC0CA6ED7381B4D41C01B4134AEBE384DC07527644B094D41C0C9DD03BBF2384DC084694344F84C41C0BD6EA64620394DC0D208B122E84C41C0EFD198FC4F394DC0F5700A01D84C41C0995F1DC573394DC032B6753FCD4C41C07FC7C82AB9394DC07B687D0CB54C41C008D757BB003A4DC0CBD770BE9D4C41C0F2AC524C483A4DC016273B55874C41C01C4DBF684C3A4DC0EAA9296B854C41C056B33314143A4DC0ACA9A6A55D4C41C04E61BC80CE394DC0753C7C722D4C41C0BD013FA6C7394DC0F794DDB2284C41C0AE6C8E29AC394DC05E9A4DA6144C41C05E8DB064AB394DC04C6BB4EA134C41C0E3B6826CAA394DC00EC5BF99134C41C08F230B6CA9394DC08C87C848134C41C04E4B186DA8394DC0D8898FF5124C41C0453C216EA7394DC0BD2AD4A0124C41C07DE1AE70A6394DC07EBA914A124C41C03C243B73A5394DC0B70B91F3114C41C087CA8976A4394DC041D20C9B114C41C05E7C967AA3394DC021C88942114C41C02CCCE37DA2394DC0716F7EE8104C41C093FBF181A1394DC06697398F104C41C07DFCC386A0394DC0D0347134104C41C0F2BF918B9F394DC0D87CE3D80F4C41C0EF5423919E394DC0D2C5D57B0F4C41C046E075979D394DC0D8F8401D0F4C41C027204D9F9C394DC071602DBD0E4C41C099E8E3A79B394DC00D6C975B0E4C41C0CE2BFBB19A394DC055DBF6F60D4C41C0E9AED7BC99394DC065C0D2900D4C41C0E02F33C998394DC0A6AB2E290D4C41C07E414ED697394DC0DFE942BF0C4C41C0D2492AE496394DC05029D7530C4C41C0F6FF8AF395394DC0AD4CA7E70B4C41C0A5C2EB0295394DC00E78B47A0B4C41C01150101394394DC01A99040D0B4C41C00407322393394DC0F22A519F0A4C41C07D64523392394DC0732D1A300A4C41C039EB374491394DC0D982A8C1094C41C067CF175590394DC064BDAF51094C41C0AFE4BC668F394DC0A6F9B6E1084C41C04FE922798E394DC0A02B0171084C41C0238D878B8D394DC03EDA84FF074C41C083ABED9D8C394DC0EFED478D074C41C0D04313B18B394DC0B28E0E1B074C41C07E323DC48A394DC048AC0EA8064C41C00E4A22D889394DC0B2BFD135064C41C091F947EB88394DC06F04D3C2054C41C0EBE132FF87394DC0A910164F054C41C09410181387394DC0855317DC044C41C08695012786394DC01CCD5668044C41C0FE3BE83A85394DC043945BF5034C41C028CBD14E84394DC0B0069B81034C41C035CDBC6283394DC09275DA0D034C41C04D1DA27682394DC0B5E0199A024C41C077A64C8B81394DC003889725024C41C0AA00329F80394DC06A77DAB1014C41C030171DB37F394DC0FAD7193E014C41C0F039C6C77E394DC0553A59CA004C41C03F11ADDB7D394DC00A1F9C56004C41C05CC996EF7C394DC0CF74DBE2FF4B41C0453D7C037C394DC0E0C61A6FFF4B41C0142463177B394DC067155AFBFE4B41C043E34C2B7A394DC0A5B15E88FE4B41C0991D383F79394DC01FF99D14FE4B41C0DC9D1D5378394DC02CD49DA1FD4B41C07174076777394DC056CEE12DFD4B41C0AA6CEE7A76394DC045A2E1BAFC4B41C0E0D8188E75394DC0D4D52047FC4B41C0786DFEA174394DC000D121D4FB4B41C03E0FE4B573394DC0378E6460FB4B41C01765CFC972394DC0668265EDFA4B41C03A11B5DD71394DC005ADA479FA4B41C04471A0F170394DC0099AA506FA4B41C07827860570394DC0E948E892F94B41C033AFB0186F394DC01629E91FF94B41C0C66F962C6E394DC05D4528ACF84B41C00AE481406D394DC076AF2C39F84B41C084A667546C394DC0E35B2CC6F74B41C0B9BF51686B394DC08A6D6B52F74B41C01AFA387C6A394DC051416CDFF64B41C0615F5F8F69394DC069D1AE6BF64B41C07F7F49A368394DC0179EAFF8F54B41C0E81A35B767394DC072A1EE84F54B41C0E6FB1ACB66394DC0D666EF11F54B41C0212B05DF65394DC030B4F39EF44B41C025AA2BF264394DC0DCA6322BF44B41C06B9A110664394DC07E6133B8F34B41C0B046FD1963394DC022A43745F34B41C08ECC232D62394DC0542337D2F24B41C0F31D0E4161394DC0870D765EF24B41C05990F55460394DC0D8B976EBF14B41C09D6E20685F394DC046E87A78F14B41C06C7D067C5E394DC0618D7B05F14B41C05191EC8F5D394DC0E52E7C92F04B41C0838717A35C394DC0BA8CBE1EF04B41C05F13FFB65B394DC01B27BFABEF4B41C0E37FE9CA5A394DC0848FBE38EF4B41C0993310DE59394DC0CB1CBFC5EE4B41C0F629452859394DC0D5D7627FEE4B41C0655E721358394DC0F6AEBEFBED4B41C0AD91D92557394DC09208088BED4B41C07CAE433856394DC0F2DE8A19ED4B41C083ABA64A55394DC078B10DA8EC4B41C0C30B4D5C54394DC0C86E5337EC4B41C043EEB26E53394DC08AC5D9C5EB4B41C0D53A1A8152394DC093811F55EB4B41C05695819351394DC0B345A2E3EA4B41C0097EE7A550394DC0DD85EB72EA4B41C09CE24EB84F394DC0BA426E01EA4B41C0F969F5C94E394DC06124F28FE94B41C0D0615BDC4D394DC0282B3A1FE94B41C079D5C2EE4C394DC09A0BBEADE84B41C086D728014C394DC0B57F023DE84B41C01C5590134B394DC050E489CBE74B41C0F6D7F7254A394DC0648B0C5AE74B41C00DF25D3849394DC0475D90E8E64B41C0F975C54A48394DC0E8C2D477E64B41C094256C5C47394DC0D8125C06E64B41C0FF30936F46394DC083B1DE94E54B41C0515FF98145394DC06A466123E54B41C03900619444394DC09D91E8B1E44B41C09738C7A643394DC0B64D6C40E44B41C0D2E32EB942394DC0C5D7EECEE34B41C06B2F95CB41394DC0CFC6B05CE34B41C0FB0FC2DE40394DC064DB36EBE24B41C08C5C28F13F394DC00089BA79E24B41C0FB1B90033F394DC08C043D08E24B41C0FFEFB5163E394DC0B8760296E14B41C07AB91D293D394DC080198624E14B41C01588853B3C394DC0278A08B3E04B41C0716BAB4E3B394DC01666CA40E04B41C0F94313613A394DC0EC5A50CFDF4B41C0F62A7B7339394DC06229125DDF4B41C018CBA68638394DC0DF4B99EBDE4B41C03A05099937394DC06CE45979DE4B41C0A1AF34AC36394DC04374DD07DE4B41C0F4AA9CBE35394DC0C1059E95DD4B41C0FC15C4D134394DC0A6192524DD4B41C0A0AD2AE433394DC054D2E6B1DC4B41C0FD2252F732394DC019256940DC4B41C0C3C4B80932394DC089D62ACEDB4B41C0D7CF201C31394DC01FA7B05CDB4B41C002A74C2F30394DC0DF5772EADA4B41C04DBCB4412F394DC046C4F578DA4B41C03454DC542E394DC09BCAB906DA4B41C0D70543672D394DC0B62F3D95D94B41C0CFED63A22C394DC0B44CEB35D94B41C0E5FB988AFC384DC05C57B015074C41C0C1CD1FD3CC384DC001DDBB1D324C41C03D819FF09A384DC0C9D80BD55F4C41C0A70608AE67384DC0455E18808F4C41C0478F4AE266384DC0B037E73D904C41C078FF8B3B2B384DC0F29F10B7C84C41C04727AC9FBC374DC06614CB8DEC4C41C064E9B4C551374DC04D70203B104D41C0","VILLA CRESPO",5113.70612569,1034522.12291,23031,10872,12159,15,3
161,"0106000020E6100000010000000103000000010000001C0000001559BD26F5374DC055BDECD0614D41C09A5A2A6FF5374DC0081AF8F2614D41C04799FFB038384DC07689B424844D41C0FB1A0F5756384DC071C8B0128C4D41C0C553B65DFE384DC0E573D500B94D41C0F5F043920B394DC025A9D6E5BD4D41C096CA96581E394DC07B4E7F44C64D41C0445B85771E394DC00604F13CC64D41C09DE80333B2394DC0E43EE38DA14D41C03BCA183FAF3A4DC093A76200604D41C0A52C1243BE3A4DC0696495155C4D41C0E6A2C5E2A43A4DC05E48CB0B4A4D41C0768971CA653A4DC01ADC8AA27D4C41C0ED96081D4D3A4DC0685300EB854C41C01C4DBF684C3A4DC0EAA9296B854C41C0F2AC524C483A4DC016273B55874C41C008D757BB003A4DC0CBD770BE9D4C41C07FC7C82AB9394DC07B687D0CB54C41C0995F1DC573394DC032B6753FCD4C41C0EFD198FC4F394DC0F5700A01D84C41C0BD6EA64620394DC0D208B122E84C41C0C9DD03BBF2384DC084694344F84C41C01B4134AEBE384DC07527644B094D41C0A6BEF8A397384DC0CA6ED7381B4D41C0538373D04C384DC09F9093CB384D41C03651E7C525384DC0F3F4D0D2494D41C07106123D05384DC0849349DA5A4D41C01559BD26F5374DC055BDECD0614D41C0","VILLA CRESPO",4846.38692469,1144949.87171,20173,9631,10542,15,3
166,"0106000020E6100000010000000103000000010000001C000000B7A618C3433C4DC008C29889314B41C08A897081513C4DC02FA883393D4B41C0CFF2808F523C4DC0EF14840C3E4B41C05ED10705673C4DC0E283B5FF4D4B41C0EF6536B9E43C4DC042F894D3AF4B41C0D748A69EE93C4DC088125B38BC4B41C0556304E4F63C4DC0909EEED2B84B41C033E37C15053D4DC088F9F330B54B41C0CA8EF4977D3D4DC0D2762297964B41C03092FE36953D4DC05FF8DD7D904B41C0CB784490AD3D4DC04A370A1D894B41C06804C1A3D73D4DC03E30F0127A4B41C02D8941D30A3E4DC02FB23E54684B41C06DD4C10F383E4DC0542B3984384B41C0FF878E7A733E4DC0C1FE579DF94A41C0492A3E73903E4DC0C4C73B9DDB4A41C0C1A7E28F903E4DC0C8325F71DB4A41C0CE7FAAC54F3D4DC0026D7FE5204A41C0A1C93F7D4F3D4DC0543D29BB204A41C00D7229C7DA3C4DC0CAF561E33B4A41C0F82BC63CC23C4DC0D37EC1EC584A41C01E9867FBAB3C4DC03C0F2A6B724A41C09741F1FF9D3C4DC0DA46E75F774A41C042EA3ADAA03C4DC0E78585917C4A41C09F316FB69F3C4DC03192A6A27F4A41C023AE446CA03C4DC09671C535814A41C0AAA68F499C3C4DC064A10B14894A41C0B7A618C3433C4DC008C29889314B41C0","PARQUE CHAS",4524.98563466,1384888.6269,15685,7487,8198,15,27
167,"0106000020E61000000100000001030000000100000023000000414CB07DEC3C4DC0F7346D2FC44B41C00C7C3B2C123D4DC0E0EF92BE2C4C41C0148BBC533A3D4DC05CB8F069964C41C0A05E075D4A3D4DC05FEBBA22C24C41C00E8ABB2BD03D4DC0FB045056884C41C070F9D822D43D4DC08FF613C7834C41C0DC60DF01D63D4DC0B4E9FDA7834C41C0E7608C79883E4DC069561962764C41C00240889ABE3E4DC0769A6FD3724C41C029A82445553F4DC0D1CA2CDE684C41C0AEC9ADB3A13F4DC05A09CB79634C41C063F2317CA33F4DC0C4140793644C41C018CC68FAF33F4DC0E3A24679464C41C03AB7A1A259404DC05C08B115214C41C07B8825885E404DC0D98F943F1F4C41C0129FC0EA6F404DC0E2F0684A184C41C0D0C404F473404DC0578C52AC164C41C0AAAC581E65404DC0D70228BB144C41C09F9680BB71404DC08757F1B8064C41C0452867C646404DC0DBC7189CEC4B41C03B75A451543F4DC0BDE20A5A564B41C09507A290903E4DC001D79970DB4A41C0C1A7E28F903E4DC0C8325F71DB4A41C0492A3E73903E4DC0C4C73B9DDB4A41C0FF878E7A733E4DC0C1FE579DF94A41C06DD4C10F383E4DC0542B3984384B41C02D8941D30A3E4DC02FB23E54684B41C06804C1A3D73D4DC03E30F0127A4B41C0CB784490AD3D4DC04A370A1D894B41C03092FE36953D4DC05FF8DD7D904B41C0CA8EF4977D3D4DC0D2762297964B41C033E37C15053D4DC088F9F330B54B41C0556304E4F63C4DC0909EEED2B84B41C0D748A69EE93C4DC088125B38BC4B41C0414CB07DEC3C4DC0F7346D2FC44B41C0","AGRONOMIA",6564.49904517,2122760.94732,12095,5764,6331,15,28
165,"0106000020E61000000100000001030000000100000024000000DC596479EA3B4DC0CFC8D010554941C082353310D23B4DC0CDFD04EC474941C0C2C546F54E3B4DC002C5AA3A9A4941C01D7E6B40493B4DC03256CCC49D4941C0266BB6B62E3B4DC0AC225182BB4941C0D97A31CDE83A4DC0B571B4A7054A41C031A5706CF23A4DC0C960287E054A41C074158277F23A4DC0E393CC2E9E4A41C0FEB5BAECF23A4DC007A1A044DF4A41C054E0F129F03A4DC03467CF12E34A41C02E2E4F3CEF3A4DC0EE94C016E94A41C0100B56F4EF3A4DC0B19E3193EA4A41C0507CBB04EE3A4DC0D9A64FA6F24A41C076CDD33E113B4DC0F7C45195FC4A41C06E5428901E3B4DC0DCC9D76D034B41C01A02D343213B4DC0523B8AB9054B41C0B88B4606463B4DC01D0C39F1244B41C0FD0C65D3753B4DC04AEF936A514B41C00E527717C13B4DC041E30F9C984B41C09C16B861C53B4DC040C0FCEA954B41C0E04C4085D43B4DC0181D34018A4B41C0D2ACB2CAED3B4DC02E22621C764B41C017EA14AD0E3C4DC080872EF35B4B41C0B7A618C3433C4DC008C29889314B41C0AAA68F499C3C4DC064A10B14894A41C023AE446CA03C4DC09671C535814A41C09F316FB69F3C4DC03192A6A27F4A41C042EA3ADAA03C4DC0E78585917C4A41C09741F1FF9D3C4DC0DA46E75F774A41C01E9867FBAB3C4DC03C0F2A6B724A41C0F82BC63CC23C4DC0D37EC1EC584A41C00D7229C7DA3C4DC0CAF561E33B4A41C0A1C93F7D4F3D4DC0543D29BB204A41C0F10D225A133D4DC065C5E0D5FE4941C0200C426B823C4DC018F392CBAB4941C0DC596479EA3B4DC0CFC8D010554941C0","VILLA ORTUZAR",5682.32439895,1853740.24651,18875,9050,9825,15,29
